seller_id,seller_click_cnt,seller_add_to_cart_cnt,seller_purchase_cnt,seller_add_to_favorite_cnt,seller_action_total_cnt,seller_purchase_rt
1,308236,444,17705,12755,339140,0.05220557881700773
2,2030,8,189,144,2371,0.07971320118093632
3,2399,4,67,175,2645,0.025330812854442344
4,2646,2,294,164,3106,0.09465550547327753
5,7483,9,144,556,8192,0.017578125
6,1390,6,82,120,1598,0.05131414267834793
7,3521,7,399,179,4106,0.0971748660496834
8,3540,3,395,306,4244,0.09307257304429783
9,2096,7,94,65,2262,0.04155614500442087
10,19125,64,1133,866,21188,0.0534736643383047
11,11397,18,1256,843,13514,0.09294065413645108
12,8548,7,592,508,9655,0.061315380631797
13,6589,15,937,301,7842,0.11948482529966845
14,5709,3,379,305,6396,0.059255784865540964
15,1616,4,178,52,1850,0.09621621621621622
16,3446,10,285,146,3887,0.0733213275019295
17,1135,1,93,77,1306,0.07120980091883614
18,3550,2,101,308,3961,0.025498611461752082
19,3319,6,453,241,4019,0.11271460562328937
20,7509,15,480,342,8346,0.05751258087706686
21,1804,3,358,174,2339,0.15305686190679776
22,1876,3,192,105,2176,0.08823529411764706
23,3789,4,209,289,4291,0.04870659519925425
24,4480,19,499,191,5189,0.0961649643476585
25,2404,9,302,163,2878,0.10493398193189715
26,5103,1,245,182,5531,0.04429578738022057
27,10022,19,401,333,10775,0.03721577726218098
28,97130,95,1621,5896,104742,0.015476122281415287
29,2841,2,213,244,3300,0.06454545454545454
30,3385,8,79,254,3726,0.021202361782071927
31,2285,8,221,100,2614,0.08454475899005356
32,3403,12,143,153,3711,0.038534087846941525
33,32941,51,2342,2917,38251,0.06122715745993569
34,10665,22,2349,809,13845,0.1696641386782232
35,8927,11,765,685,10388,0.07364266461301502
36,870,0,120,61,1051,0.11417697431018078
37,3246,2,573,297,4118,0.1391452161243322
38,3073,12,126,250,3461,0.036405663103149376
39,1602,1,305,107,2015,0.1513647642679901
40,16906,36,332,1036,18310,0.018132168214090662
41,3705,7,223,166,4101,0.05437698122409169
42,6148,1,120,190,6459,0.018578727357176035
43,7744,19,807,461,9031,0.08935887498615878
44,13809,9,873,803,15494,0.056344391377307346
45,583,0,70,42,695,0.10071942446043165
46,3473,8,555,136,4172,0.13302972195589646
47,3220,1,602,333,4156,0.14485081809432146
48,1402,6,146,93,1647,0.08864602307225258
49,1098,0,32,63,1193,0.026823134953897737
50,3448,6,329,267,4050,0.08123456790123457
51,7652,15,426,777,8870,0.04802705749718151
52,925,2,77,77,1081,0.07123034227567067
53,12120,11,316,771,13218,0.023906793766076562
54,7781,16,790,558,9145,0.08638600328048114
55,15013,14,381,1045,16453,0.023156871087339694
56,14712,32,548,1202,16494,0.033224202740390445
57,1861,5,75,123,2064,0.036337209302325583
58,3988,10,813,335,5146,0.15798678585308978
59,4164,11,252,176,4603,0.05474690419291766
60,12675,12,2196,779,15662,0.14021197803601074
61,1160,2,117,68,1347,0.08685968819599109
62,7003,1,1207,580,8791,0.13729951086338302
63,24692,82,982,1869,27625,0.03554751131221719
64,378,0,8,9,395,0.020253164556962026
65,4919,7,879,489,6294,0.13965681601525262
66,34942,63,4809,1906,41720,0.11526845637583892
67,2499,1,395,106,3001,0.1316227924025325
68,6848,10,737,370,7965,0.09252981795354677
69,4709,6,200,269,5184,0.038580246913580245
70,2683,6,95,153,2937,0.032345931222335714
71,23451,21,1653,947,26072,0.06340135010739491
72,15226,17,440,1455,17138,0.025673940949935817
73,4936,9,290,400,5635,0.05146406388642413
74,14552,12,815,846,16225,0.05023112480739599
75,2114,3,177,116,2410,0.07344398340248963
76,5406,20,470,318,6214,0.07563566140971999
77,2860,0,56,96,3012,0.01859229747675963
78,8393,14,737,680,9824,0.07502035830618893
79,8700,11,593,789,10093,0.058753591598137325
80,1841,1,136,67,2045,0.06650366748166259
81,2221,7,147,107,2482,0.05922643029814666
82,7520,17,395,467,8399,0.04702940826288844
83,4966,15,556,229,5766,0.09642733263961152
84,17635,41,2221,828,20725,0.10716525934861279
85,1685,4,207,90,1986,0.1042296072507553
86,17712,19,538,1060,19329,0.027833824822805112
87,2847,0,474,285,3606,0.1314475873544093
88,3337,8,155,309,3809,0.04069309530060383
89,4069,10,210,330,4619,0.045464386230785886
90,1782,3,46,79,1910,0.024083769633507852
91,1541,2,73,67,1683,0.04337492572786691
92,2778,4,261,240,3283,0.07950045689917758
93,12076,20,128,1059,13283,0.009636377324399608
94,5962,9,173,449,6593,0.026239951463673594
95,6706,12,228,486,7432,0.030678148546824543
96,2818,3,282,158,3261,0.08647654093836246
97,2088,5,159,99,2351,0.06763079540621013
98,6527,5,914,579,8025,0.11389408099688474
99,451,0,118,17,586,0.20136518771331058
100,4055,7,538,181,4781,0.11252875967370843
101,6653,22,664,378,7717,0.08604379940391343
102,15281,18,869,972,17140,0.05070011668611435
103,2962,5,92,283,3342,0.02752842609216038
104,7124,16,1152,421,8713,0.13221622862389532
105,367,0,45,22,434,0.10368663594470046
106,29324,55,1625,3301,34305,0.04736918816499053
107,4949,8,159,433,5549,0.028653811497567128
108,2539,5,82,193,2819,0.02908832919474991
109,5330,9,202,615,6156,0.03281351526965562
110,1076,5,164,36,1281,0.12802498048399688
111,15080,34,2115,1117,18346,0.11528398560994223
112,1119,3,110,52,1284,0.08566978193146417
113,2000,4,137,146,2287,0.059903804110188016
114,21210,11,1583,1197,24001,0.06595558518395067
115,5551,7,145,187,5890,0.02461799660441426
116,14081,17,753,868,15719,0.04790381067497933
117,1026,2,100,83,1211,0.08257638315441784
118,8785,27,368,521,9701,0.03793423358416658
119,1517,3,112,133,1765,0.06345609065155808
120,6212,11,1017,361,7601,0.13379818444941455
121,72265,121,4780,2699,79865,0.05985099856007012
122,3807,7,168,237,4219,0.039819862526665084
123,1999,3,274,133,2409,0.11374014113740141
124,1225,0,136,37,1398,0.09728183118741059
125,5930,6,66,490,6492,0.010166358595194085
126,207,0,15,9,231,0.06493506493506493
127,9644,4,803,756,11207,0.07165164629249576
128,1382,7,97,56,1542,0.062905317769131
129,2332,4,113,168,2617,0.043179212839128775
130,1835,3,124,195,2157,0.05748725081131201
131,25468,30,1105,2776,29379,0.03761189965621702
132,4887,5,480,362,5734,0.08371119637251483
133,17227,54,1035,1679,19995,0.051762940735183796
134,3386,12,391,202,3991,0.09797043347531947
135,2528,3,104,143,2778,0.037437005039596835
136,6781,6,173,361,7321,0.023630651550334655
137,4337,6,469,215,5027,0.09329620051720708
138,5057,0,519,398,5974,0.08687646468028122
139,29139,37,735,1748,31659,0.023216147067184688
140,10087,17,387,829,11320,0.034187279151943466
141,89427,103,3868,6618,100016,0.03867381219004959
142,13213,29,2610,1494,17346,0.150466966447596
143,894,5,48,75,1022,0.046966731898238745
144,25080,31,1423,1969,28503,0.04992456934357787
145,18504,51,1527,1695,21777,0.0701198512191762
146,2788,2,410,169,3369,0.12169783318492135
147,711,0,108,20,839,0.12872467222884387
148,21047,39,2690,878,24654,0.10911008355642086
149,2765,1,74,127,2967,0.02494101786316144
150,316,2,64,21,403,0.1588089330024814
151,3983,3,519,227,4732,0.10967878275570583
152,6829,12,763,503,8107,0.09411619588010361
153,1084,1,82,116,1283,0.06391270459859703
154,3671,3,734,197,4605,0.15939196525515745
155,2953,2,287,218,3460,0.08294797687861272
156,1603,3,71,131,1808,0.03926991150442478
157,951,4,104,69,1128,0.09219858156028368
158,127816,124,3307,5808,137055,0.024128999306847615
159,3039,2,232,131,3404,0.0681551116333725
160,2148,5,83,108,2344,0.035409556313993173
161,6805,6,474,377,7662,0.06186374314800313
162,960,1,46,63,1070,0.04299065420560748
163,2983,1,198,111,3293,0.06012754327361069
164,395,2,43,34,474,0.09071729957805907
165,12918,23,500,1061,14502,0.034478003034064265
166,4949,0,233,297,5479,0.04252600839569264
167,63235,43,808,2802,66888,0.012079894749431885
168,21103,41,3616,573,25333,0.14273872024631903
169,1287,3,66,85,1441,0.04580152671755725
170,3008,3,184,336,3531,0.05210988388558482
171,6810,16,1004,208,8038,0.1249066932072655
172,9181,28,195,784,10188,0.019140164899882215
173,144415,194,4377,12262,161248,0.02714452272276245
174,2872,3,439,84,3398,0.12919364331959976
175,4534,2,160,348,5044,0.0317208564631245
176,3094,1,389,201,3685,0.10556309362279512
177,1524,2,75,84,1685,0.04451038575667656
178,4901,15,278,317,5511,0.050444565414625296
179,1336,6,126,136,1604,0.07855361596009976
180,1191,6,33,105,1335,0.024719101123595506
181,13810,6,188,675,14679,0.01280741194904285
182,1426,4,114,119,1663,0.06855081178592905
183,2279,2,313,192,2786,0.11234745154343144
184,598893,99,4671,10148,613811,0.007609834297528067
185,82,18,454,758,1312,0.34603658536585363
186,14389,10,1137,986,16522,0.06881733446314006
187,3460,1,309,201,3971,0.07781415260639638
188,7001,9,110,555,7675,0.014332247557003257
189,4101,9,165,280,4555,0.036223929747530186
190,2889,9,307,238,3443,0.08916642462968341
191,32875,22,1278,3755,37930,0.033693646190350646
192,23006,35,2312,921,26274,0.08799573723072239
193,717,1,43,20,781,0.05505761843790013
194,2803,5,231,175,3214,0.07187305538270068
195,14962,7,299,1201,16469,0.01815532212034732
196,2599,5,243,306,3153,0.07706945765937202
197,4660,5,192,390,5247,0.03659233847913093
198,2036,3,284,142,2465,0.1152129817444219
199,33936,86,3463,2180,39665,0.08730618933568637
200,3975,7,494,450,4926,0.10028420625253756
201,2902,4,327,123,3356,0.09743742550655542
202,48444,54,830,2952,52280,0.015876052027543993
203,8309,23,1610,638,10580,0.15217391304347827
204,608,1,70,29,708,0.09887005649717515
205,5462,6,433,309,6210,0.06972624798711755
206,7426,6,662,410,8504,0.07784571966133584
207,20682,38,2294,1159,24173,0.09489926777809954
208,461,0,53,18,532,0.09962406015037593
209,1187,5,85,58,1335,0.06367041198501873
210,1307,1,218,136,1662,0.13116726835138387
211,2350,5,144,169,2668,0.053973013493253376
212,6686,15,952,371,8024,0.11864406779661017
213,9583,17,816,346,10762,0.07582233785541721
214,3787,9,182,155,4133,0.04403580933946286
215,17285,23,1167,844,19319,0.060406853356799003
216,1302,7,117,80,1506,0.07768924302788845
217,1672,1,274,41,1988,0.13782696177062373
218,18779,26,2033,918,21756,0.09344548630262917
219,25915,59,2810,1903,30687,0.09156972007690553
220,5244,7,588,281,6120,0.09607843137254903
221,2801,1,675,234,3711,0.18189167340339532
222,6689,8,595,360,7652,0.07775744903293257
223,1467,0,102,101,1670,0.06107784431137724
224,1305,2,93,88,1488,0.0625
225,5718,10,461,293,6482,0.07112002468373958
226,2691,4,300,337,3332,0.09003601440576231
227,16705,29,730,1145,18609,0.03922833037777419
228,2482,8,557,157,3204,0.17384519350811486
229,1088,4,19,61,1172,0.016211604095563138
230,1909,1,403,103,2416,0.1668046357615894
231,7222,5,81,294,7602,0.010655090765588003
232,51721,55,1380,2790,55946,0.024666642834161513
233,8890,11,896,498,10295,0.08703254006799417
234,18173,31,2224,1232,21660,0.10267774699907664
235,8784,9,663,514,9970,0.06649949849548646
236,4128,7,405,233,4773,0.08485229415461974
237,393,0,36,35,464,0.07758620689655173
238,3585,9,118,211,3923,0.030079021157277595
239,6657,17,314,430,7418,0.04232946885953087
240,2836,3,328,81,3248,0.10098522167487685
241,6054,6,792,384,7236,0.10945273631840796
242,9320,9,604,849,10782,0.056019291411611945
243,1568,2,149,88,1807,0.08245711123408965
244,2627,7,43,194,2871,0.014977359804946012
245,3123,7,244,221,3595,0.0678720445062587
246,5582,12,400,257,6251,0.0639897616381379
247,2786,10,468,252,3516,0.13310580204778158
248,17300,9,2722,1149,21180,0.12851746931067046
249,1593,0,133,121,1847,0.07200866269626421
250,8188,10,1424,941,10563,0.13481018650004734
251,4264,8,381,196,4849,0.0785729016292019
252,4120,3,753,146,5022,0.14994026284348866
253,1399,1,99,96,1595,0.06206896551724138
254,7246,12,373,183,7814,0.04773483491169695
255,7282,15,460,357,8114,0.05669213704707912
256,923,2,132,51,1108,0.11913357400722022
257,2463,7,202,247,2919,0.06920178143199726
258,3560,5,94,234,3893,0.024145902902645774
259,4501,10,359,275,5145,0.06977648202137998
260,5815,18,382,323,6538,0.05842765371673295
261,3919,11,801,246,4977,0.1609403254972875
262,4030,1,654,243,4928,0.13271103896103897
263,2377,1,174,141,2693,0.06461195692536205
264,946,3,102,55,1106,0.0922242314647378
265,6352,8,652,493,7505,0.08687541638907395
266,5641,8,468,493,6610,0.0708018154311649
267,17040,39,1060,1554,19693,0.05382623267150764
268,4817,8,180,117,5122,0.035142522452167126
269,792,1,85,25,903,0.09413067552602436
270,54110,47,5316,3822,63295,0.08398767675171814
271,944,0,220,22,1186,0.18549747048903878
272,2119,1,170,117,2407,0.07062733693394267
273,2024,0,309,144,2477,0.12474767864352039
274,4161,10,125,262,4558,0.027424308907415533
275,11159,14,969,752,12894,0.07515123313168916
276,1686,6,108,181,1981,0.05451792024230187
277,338,0,21,17,376,0.05585106382978723
278,8314,17,352,612,9295,0.0378698224852071
279,16156,10,2269,1102,19537,0.11613860879357117
280,1067,4,107,82,1260,0.08492063492063492
281,1319,8,132,92,1551,0.0851063829787234
282,5121,10,857,184,6172,0.13885288399222295
283,8033,10,789,408,9240,0.08538961038961039
284,26828,67,1944,1374,30213,0.064343163538874
285,6276,24,651,268,7219,0.09017869511012605
286,8731,29,930,221,9911,0.09383513268085965
287,5758,9,133,471,6371,0.020875843666614345
288,2686,11,117,140,2954,0.03960731211916046
289,2603,8,262,170,3043,0.08609924416694052
290,7857,20,1758,430,10065,0.17466467958271237
291,8885,13,1288,322,10508,0.12257327750285497
292,1207,2,293,91,1593,0.18392969240426868
293,8677,40,1116,685,10518,0.10610382201939532
294,8908,7,315,1164,10394,0.030305945737925725
295,3321,14,148,301,3784,0.039112050739957716
296,15750,22,1632,669,18073,0.0903004481823715
297,5588,15,434,280,6317,0.06870349849612158
298,3362,9,107,183,3661,0.0292269871619776
299,3149,3,369,155,3676,0.10038084874863983
300,13617,8,222,423,14270,0.015557112824106517
301,8057,5,1825,439,10326,0.1767383304280457
302,3843,5,750,150,4748,0.15796124684077506
303,2067,1,147,126,2341,0.06279367791542076
304,3444,8,329,176,3957,0.0831437958049027
305,25596,89,2338,1243,29266,0.07988792455409006
306,9906,7,680,372,10965,0.06201550387596899
307,675,2,96,29,802,0.11970074812967581
308,4094,6,263,227,4590,0.05729847494553377
309,2925,6,798,925,4654,0.17146540610227762
310,23539,95,2750,1269,27653,0.09944671464217264
311,5437,8,560,317,6322,0.08857956342929453
312,1994,5,85,102,2186,0.03888380603842635
313,5514,5,461,256,6236,0.07392559332905708
314,4161,13,312,219,4705,0.06631243358129649
315,1351,1,73,51,1476,0.0494579945799458
316,11661,19,1313,623,13616,0.09643066980023501
317,6551,31,303,404,7289,0.04156948826999588
318,39225,63,2876,2500,44664,0.06439190399426832
319,2076,6,252,104,2438,0.10336341263330599
320,8626,8,1176,653,10463,0.11239606231482366
321,2709,11,132,227,3079,0.04287106203312764
322,4045,2,689,245,4981,0.13832563742220438
323,25895,51,1965,1878,29789,0.06596394642317634
324,2472,9,107,206,2794,0.03829634931997137
325,2965,6,97,217,3285,0.029528158295281583
326,7249,16,1027,328,8620,0.1191415313225058
327,18197,43,1613,1007,20860,0.07732502396931927
328,880,2,61,88,1031,0.05916585838991271
329,3098,9,298,161,3566,0.08356702187324734
330,436,1,56,25,518,0.10810810810810811
331,84066,90,2311,5395,91862,0.02515730116914502
332,6082,7,149,578,6816,0.021860328638497652
333,10387,14,1476,351,12228,0.12070657507360157
334,1582,2,71,68,1723,0.0412071967498549
335,3725,9,204,190,4128,0.04941860465116279
336,1615,2,90,96,1803,0.04991680532445923
337,3202,1,252,117,3572,0.07054871220604703
338,1406,2,204,54,1666,0.12244897959183673
339,6964,5,229,545,7743,0.029575100090404236
340,2612,7,324,115,3058,0.10595160235448005
341,3317,4,262,223,3806,0.06883867577509196
342,8126,17,1491,476,10110,0.14747774480712167
343,1805,5,289,51,2150,0.1344186046511628
344,2796,1,106,168,3071,0.03451644415499837
345,2283,3,193,100,2579,0.07483520744474603
346,6001,8,290,335,6634,0.043714199577931864
347,30989,60,2396,1957,35402,0.06767979210214112
348,2292,5,133,128,2558,0.05199374511336982
349,2472,6,78,233,2789,0.027967013266403728
350,3907,8,381,354,4650,0.08193548387096775
351,2352,3,427,150,2932,0.1456343792633015
352,2320,7,101,140,2568,0.03933021806853582
353,784,0,60,73,917,0.06543075245365322
354,5303,5,789,307,6404,0.12320424734540912
355,7610,9,479,707,8805,0.05440090857467348
356,2677,8,120,176,2981,0.040254948004025494
357,2345,15,334,127,2821,0.11839773130095711
358,2468,5,124,172,2769,0.04478150957024196
359,12728,11,1181,584,14504,0.08142581356867071
360,2476,6,414,138,3034,0.13645352669742913
361,72546,211,4932,5113,82802,0.059563778652689546
362,2344,2,168,236,2750,0.06109090909090909
363,3611,7,610,186,4414,0.13819664703217036
364,2618,1,107,94,2820,0.03794326241134752
365,2148,1,198,125,2472,0.08009708737864078
366,5653,7,749,312,6721,0.11144174973962208
367,2128,6,76,111,2321,0.03274450667815597
368,4071,4,408,151,4634,0.0880448856279672
369,2817,0,192,195,3204,0.0599250936329588
370,4255,7,712,300,5274,0.13500189609404625
371,2539,3,315,177,3034,0.10382333553065261
372,2645,10,189,98,2942,0.06424201223657376
373,14101,7,416,754,15278,0.027228694855347558
374,2898,4,189,193,3284,0.05755176613885506
375,103305,238,3221,5441,112205,0.028706385633438795
376,3442,3,212,134,3791,0.05592192033764178
377,1222,2,85,95,1404,0.06054131054131054
378,1875,1,123,105,2104,0.05846007604562738
379,5043,5,113,352,5513,0.02049700707418828
380,31683,20,1053,1885,34641,0.030397505845674203
381,1220,0,250,146,1616,0.1547029702970297
382,2545,6,240,100,2891,0.08301625735039779
383,1946,6,116,167,2235,0.05190156599552573
384,6345,7,424,227,7003,0.06054548050835356
385,839,1,143,54,1037,0.13789778206364514
386,4900,6,611,444,5961,0.10249958060728066
387,11468,27,392,1271,13158,0.029791761665906673
388,6854,3,547,391,7795,0.07017318794098781
389,2515,2,151,145,2813,0.05367934589406328
390,16889,19,2605,1265,20778,0.12537299066320146
391,1073,4,166,77,1320,0.12575757575757576
392,859,4,33,58,954,0.03459119496855346
393,2902,2,80,221,3205,0.0249609984399376
394,914,2,141,68,1125,0.12533333333333332
395,2710,4,207,186,3107,0.06662375281622143
396,3952,4,1149,211,5316,0.21613995485327314
397,24600,17,2124,1065,27806,0.07638639142631087
398,3336,10,269,194,3809,0.07062221055395117
399,2598,4,343,203,3148,0.10895806861499364
400,3820,4,66,216,4106,0.01607403799318071
401,22755,40,1029,1723,25547,0.04027870200023486
402,7175,15,608,495,8293,0.07331484384420596
403,2678,6,294,206,3184,0.09233668341708542
404,2430,6,156,134,2726,0.05722670579603815
405,1361,2,106,86,1555,0.06816720257234726
406,5951,10,458,404,6823,0.06712589769895941
407,1451,6,85,156,1698,0.05005889281507656
408,573,1,115,28,717,0.1603905160390516
409,2111,2,153,115,2381,0.06425871482570349
410,1134,3,115,88,1340,0.08582089552238806
411,21580,20,2872,1593,26065,0.11018607327834261
412,53268,39,1545,2813,57665,0.026792681869418192
413,956,2,171,30,1159,0.14754098360655737
414,19320,16,460,1290,21086,0.02181542255524993
415,7116,19,1090,530,8755,0.12450028555111364
416,93595,119,4647,5616,103977,0.04469257624282293
417,2291,0,265,104,2660,0.09962406015037593
418,5784,7,449,283,6523,0.0688333588839491
419,2182,2,219,99,2502,0.08752997601918465
420,197190,247,7117,9200,213754,0.03329528336311835
421,3041,5,122,328,3496,0.03489702517162471
422,75485,150,9226,2549,87410,0.10554856423750143
423,12882,28,813,1130,14853,0.05473641688547768
424,21224,30,1492,1806,24552,0.06076898012381883
425,1450,2,201,68,1721,0.1167925624636839
426,1746,4,241,94,2085,0.11558752997601919
427,1396,7,94,56,1553,0.06052801030264005
428,4183,8,551,282,5024,0.10967356687898089
429,15595,10,1295,747,17647,0.07338357794525982
430,3579,3,374,205,4161,0.08988223984619081
431,13112,5,198,1319,14634,0.013530135301353014
432,2081,7,79,244,2411,0.032766486934881794
433,3108,3,362,197,3670,0.09863760217983651
434,3714,19,269,305,4307,0.062456466217785
435,9228,30,338,692,10288,0.03285381026438569
436,2748,5,128,170,3051,0.04195345788266142
437,73645,78,1874,4260,79857,0.023466947168062913
438,1385,0,216,96,1697,0.12728344136711844
439,906,4,67,52,1029,0.06511175898931001
440,561,0,49,46,656,0.07469512195121951
441,1699,7,155,72,1933,0.0801862390067253
442,6921,5,193,707,7826,0.024661385126501404
443,2042,7,203,135,2387,0.08504398826979472
444,18062,22,2091,1117,21292,0.09820589892917528
445,5878,16,844,350,7088,0.1190744920993228
446,2782,5,74,147,3008,0.024601063829787235
447,9322,12,1979,430,11743,0.16852593034148003
448,2470,5,88,104,2667,0.032995875515560553
449,10808,21,1279,600,12708,0.10064526282656594
450,5357,6,365,360,6088,0.059954007884362684
451,432,0,15,33,480,0.03125
452,2118,2,288,178,2586,0.11136890951276102
453,6397,5,1043,203,7648,0.1363755230125523
454,1807,1,60,144,2012,0.02982107355864811
455,3052,6,410,247,3715,0.11036339165545088
456,18406,21,2505,1324,22256,0.11255391804457225
457,12557,14,1142,1021,14734,0.07750780507669336
458,3975,6,305,260,4546,0.06709194896612407
459,1273,4,82,131,1490,0.05503355704697987
460,1577,3,286,138,2004,0.14271457085828343
461,150627,138,2514,9266,162545,0.015466486203820481
462,4351,5,177,232,4765,0.03714585519412382
463,3624,4,221,171,4020,0.054975124378109454
464,8152,26,571,462,9211,0.06199109760069482
465,47720,8,1092,2893,51713,0.021116547096474775
466,910,3,65,65,1043,0.062320230105465
467,39417,58,5222,2818,47515,0.10990213616752605
468,9881,18,1564,531,11994,0.13039853259963316
469,6428,5,2233,210,8876,0.25157728706624605
470,39975,32,2034,1297,43338,0.04693340717153537
471,15085,22,328,1004,16439,0.019952551858385546
472,3492,8,676,118,4294,0.1574289706567303
473,7534,21,486,575,8616,0.056406685236768804
474,55822,62,9296,2927,68107,0.13649110957757646
475,1902,6,155,152,2215,0.06997742663656885
476,3869,15,344,175,4403,0.07812854871678401
477,9398,24,510,864,10796,0.04723971841422749
478,7061,19,521,450,8051,0.06471245807974164
479,5729,9,614,315,6667,0.09209539523023849
480,2035,8,149,136,2328,0.06400343642611683
481,5435,12,254,527,6228,0.040783558124598586
482,1743,1,258,78,2080,0.12403846153846154
483,17602,58,843,1090,19593,0.043025570356760065
484,5779,15,342,452,6588,0.05191256830601093
485,6632,10,1752,516,8910,0.19663299663299663
486,534,1,37,32,604,0.061258278145695365
487,11013,6,83,427,11529,0.007199236707433429
488,559,1,59,14,633,0.09320695102685624
489,2235,2,465,167,2869,0.16207737887765772
490,1039,2,112,43,1196,0.09364548494983277
491,1931,4,138,144,2217,0.06224627875507442
492,3913,11,433,492,4849,0.08929676221901423
493,2547,4,101,401,3053,0.033082214215525714
494,2661,8,289,152,3110,0.09292604501607717
495,1597,9,61,97,1764,0.03458049886621315
496,8658,13,393,503,9567,0.04107870805895265
497,609,0,66,40,715,0.09230769230769231
498,2655,6,115,139,2915,0.03945111492281304
499,2863,6,364,117,3350,0.10865671641791044
500,7229,3,1032,369,8633,0.11954129503069616
501,28283,27,1058,1501,30869,0.03427386698629693
502,5504,7,625,475,6611,0.09453940402359703
503,32934,74,3452,1889,38349,0.09001538501655845
504,1314,1,225,74,1614,0.13940520446096655
505,2494,2,241,110,2847,0.08465050930804355
506,25430,30,1736,1358,28554,0.06079708622259578
507,4714,5,196,357,5272,0.03717754172989378
508,8674,18,1170,501,10363,0.11290166940075268
509,676,2,51,27,756,0.06746031746031746
510,7322,10,643,378,8353,0.07697833113851311
511,1793,1,102,150,2046,0.04985337243401759
512,1853,9,67,148,2077,0.03225806451612903
513,4660,3,852,197,5712,0.14915966386554622
514,4714,10,697,230,5651,0.12334100159263847
515,1518,6,263,81,1868,0.14079229122055675
516,2603,4,99,149,2855,0.03467600700525394
517,1244,5,65,57,1371,0.04741064916119621
518,2160,5,190,62,2417,0.07860984691766652
519,5271,1,407,345,6024,0.06756308100929614
520,3138,3,451,180,3772,0.11956521739130435
521,4913,7,231,214,5365,0.04305684995340168
522,5759,21,550,386,6716,0.08189398451459202
523,33264,37,1705,2153,37159,0.045883904303129795
524,11676,17,346,1053,13092,0.02642835319278949
525,6199,8,863,391,7461,0.11566814099986597
526,1477,2,52,184,1715,0.030320699708454812
527,53813,43,1339,3440,58635,0.02283618998891447
528,6751,5,608,417,7781,0.07813905667651973
529,1487,2,202,84,1775,0.11380281690140845
530,4891,7,378,575,5851,0.06460434113826696
531,723,1,85,51,860,0.09883720930232558
532,2365,2,136,120,2623,0.05184902783072817
533,19821,30,1477,1238,22566,0.06545245058938226
534,14339,21,1001,734,16095,0.06219322771046909
535,8510,9,308,680,9507,0.032397181024508254
536,4235,1,556,458,5250,0.1059047619047619
537,1634,1,212,94,1941,0.10922205048943844
538,6349,8,880,380,7617,0.11553104896941054
539,4603,5,116,195,4919,0.02358202886765603
540,6003,22,185,532,6742,0.02743992880450905
541,45702,111,1436,4252,51501,0.027882953729053805
542,1518,10,376,56,1960,0.19183673469387755
543,2766,2,142,204,3114,0.045600513808606295
544,3542,2,195,218,3957,0.04927975739196361
545,1617,4,83,98,1802,0.04605993340732519
546,12788,18,2844,369,16019,0.17753917223297336
547,27979,47,1329,2044,31399,0.04232618873212523
548,2840,2,118,114,3074,0.038386467143786594
549,2599,1,309,226,3135,0.09856459330143541
550,4445,8,723,190,5366,0.13473723443906074
551,5034,1,253,240,5528,0.04576700434153401
552,3995,6,171,255,4427,0.03862660944206009
553,954,5,107,49,1115,0.09596412556053811
554,8712,8,220,606,9546,0.023046302116069558
555,2321,5,418,151,2895,0.1443868739205527
556,26156,53,1218,1217,28644,0.04252199413489736
557,5474,15,590,274,6353,0.09286951046749567
558,4340,14,417,179,4950,0.08424242424242424
559,445,0,70,28,543,0.1289134438305709
560,2921,5,142,232,3300,0.04303030303030303
561,9748,11,1975,339,12073,0.16358817195394681
562,1281,2,131,60,1474,0.08887381275440977
563,5858,7,938,448,7251,0.12936146738380913
564,1697,1,151,164,2013,0.07501241927471436
565,7651,16,693,314,8674,0.07989393590039198
566,17967,18,438,383,18806,0.023290439221525044
567,61835,129,1889,5122,68975,0.027386734324030444
568,682,2,43,46,773,0.055627425614489
569,993,1,219,45,1258,0.1740858505564388
570,1557,3,116,70,1746,0.06643757159221077
571,5814,3,74,265,6156,0.012020792722547108
572,2304,1,244,201,2750,0.08872727272727272
573,4137,9,483,449,5078,0.09511618747538401
574,10913,24,944,314,12195,0.07740877408774088
575,4159,3,559,275,4996,0.11188951160928742
576,3795,9,100,334,4238,0.023596035865974516
577,4434,9,690,258,5391,0.12799109627156371
578,25028,23,2816,1173,29040,0.09696969696969697
579,3156,12,298,184,3650,0.08164383561643836
580,396,4,47,25,472,0.09957627118644068
581,1191,1,51,54,1297,0.03932151117964534
582,3340,7,66,144,3557,0.018554962046668542
583,2538,6,485,123,3152,0.15387055837563451
584,2930,1,437,165,3533,0.12369091423719218
585,4403,8,1887,200,6498,0.2903970452446907
586,57318,62,3398,2863,63641,0.05339325277729765
587,7744,15,681,526,8966,0.07595360249832701
588,6039,24,931,535,7529,0.12365519989374418
589,3125,4,131,174,3434,0.03814793244030285
590,14582,4,1070,353,16009,0.06683740396027235
591,13142,6,165,982,14295,0.011542497376705142
592,1641,6,127,103,1877,0.06766116142781034
593,1392,3,231,128,1754,0.13169897377423034
594,8679,14,1263,535,10491,0.12038890477552187
595,8512,6,680,270,9468,0.07182087029995775
596,3790,10,432,155,4387,0.09847276042853886
597,5094,4,246,217,5561,0.04423664808487682
598,82733,206,4727,4229,91895,0.051439142499591924
599,4253,2,766,159,5180,0.14787644787644788
600,2621,12,130,236,2999,0.04334778259419807
601,13125,21,652,773,14571,0.04474641411021893
602,3894,2,296,199,4391,0.067410612616716
603,7706,14,411,505,8636,0.04759147753589625
604,7168,13,293,597,8071,0.03630281253871887
605,2238,7,129,145,2519,0.051210797935688765
606,259847,316,6228,17377,283768,0.021947506413690056
607,4084,5,81,247,4417,0.018338238623500112
608,30291,61,2104,1491,33947,0.06197896721359767
609,17062,67,1571,1453,20153,0.07795365454274798
610,4088,2,335,374,4799,0.06980620962700562
611,1032,2,89,55,1178,0.07555178268251274
612,24948,43,956,732,26679,0.035833427039994
613,1009,0,59,156,1224,0.04820261437908497
614,2371,1,605,118,3095,0.19547657512116318
615,15156,12,1111,549,16828,0.06602091751842168
616,3556,8,101,163,3828,0.02638453500522466
617,2920,6,525,375,3826,0.1372190277051751
618,932,1,33,60,1026,0.03216374269005848
619,3631,2,207,134,3974,0.052088575742325116
620,2691,8,88,150,2937,0.0299625468164794
621,2928,7,283,208,3426,0.08260361938120257
622,11402,19,510,677,12608,0.0404505076142132
623,50866,79,885,3591,55421,0.01596867613359557
624,693,0,62,45,800,0.0775
625,20680,45,1307,1677,23709,0.055126745117887725
626,5259,15,746,263,6283,0.11873308928855643
627,4992,9,91,239,5331,0.017069968111048585
628,93847,85,1327,6411,101670,0.013052031080948165
629,8929,10,510,543,9992,0.05104083266613291
630,19359,20,845,1266,21490,0.03932061423918101
631,3830,9,230,251,4320,0.05324074074074074
632,970,0,59,89,1118,0.052772808586762074
633,1752,4,97,149,2002,0.04845154845154845
634,691,4,58,36,789,0.07351077313054499
635,12744,29,807,556,14136,0.057088285229202035
636,2239,2,201,215,2657,0.07564922845314265
637,4220,1,733,289,5243,0.13980545489223728
638,19138,22,2447,1257,22864,0.10702414275717285
639,9230,19,1241,349,10839,0.11449395700710398
640,13524,8,342,378,14252,0.023996632051641875
641,3592,4,287,193,4076,0.07041216879293424
642,1686,3,85,117,1891,0.0449497620306716
643,100331,165,4596,5190,110282,0.04167497869099218
644,75267,33,1083,6432,82815,0.01307734106140192
645,2133,1,216,134,2484,0.08695652173913043
646,4133,7,363,196,4699,0.07725047882528198
647,1839,5,308,155,2307,0.13350671868227135
648,1613,14,119,95,1841,0.06463878326996197
649,13078,16,706,1026,14826,0.047619047619047616
650,5350,7,346,229,5932,0.05832771409305462
651,71932,63,944,2100,75039,0.0125801250016658
652,3742,5,566,143,4456,0.1270197486535009
653,5587,20,557,337,6501,0.08567912628826334
654,4829,8,264,271,5372,0.049143708116157855
655,2429,7,328,180,2944,0.11141304347826086
656,1861,6,78,147,2092,0.0372848948374761
657,7197,5,1165,297,8664,0.13446445060018467
658,1344,1,101,82,1528,0.06609947643979057
659,15947,6,167,436,16556,0.010086977530804541
660,3799,6,419,172,4396,0.09531392174704277
661,3862,2,717,283,4864,0.1474095394736842
662,458,2,45,21,526,0.08555133079847908
663,8594,9,467,314,9384,0.04976555839727195
664,12118,21,271,842,13252,0.020449743434953215
665,3780,5,280,175,4240,0.0660377358490566
666,2989,6,256,188,3439,0.07444024425705147
667,3260,14,166,188,3628,0.04575523704520397
668,1037,1,87,28,1153,0.07545533391153512
669,8365,9,270,481,9125,0.02958904109589041
670,1201,2,74,55,1332,0.05555555555555555
671,1159,3,184,41,1387,0.13266041816870944
672,2119,1,71,222,2413,0.029423953584749276
673,2099,1,643,91,2834,0.2268877911079746
674,12956,30,1232,590,14808,0.08319827120475419
675,3235,11,160,260,3666,0.0436442989634479
676,2255,2,461,207,2925,0.1576068376068376
677,5092,7,604,343,6046,0.09990076083360899
678,2519,9,184,323,3035,0.06062602965403625
679,612,0,37,21,670,0.05522388059701493
680,2284,8,287,132,2711,0.10586499446698636
681,207,1,13,13,234,0.05555555555555555
682,30013,72,2990,2560,35635,0.08390627192367055
683,27556,54,586,2030,30226,0.019387282472043937
684,10630,73,776,437,11916,0.06512252433702585
685,28168,86,2776,899,31929,0.0869429045695136
686,2379,5,317,112,2813,0.11269107714184146
687,6341,8,918,680,7947,0.11551528878822197
688,5016,5,624,359,6004,0.1039307128580946
689,982,1,105,35,1123,0.09349955476402494
690,1182,4,48,100,1334,0.035982008995502246
691,4728,2,754,174,5658,0.13326263697419582
692,2961,17,58,235,3271,0.01773158055640477
693,1163,0,111,62,1336,0.08308383233532934
694,1357,3,114,106,1580,0.07215189873417721
695,1293,8,140,128,1569,0.08922880815806246
696,5769,4,500,214,6487,0.07707723138584863
697,2500,5,301,178,2984,0.10087131367292225
698,3021,13,448,155,3637,0.12317844377233984
699,1145,0,15,43,1203,0.012468827930174564
700,1703,5,173,91,1972,0.08772819472616633
701,2534,2,71,100,2707,0.026228297007757664
702,8637,4,235,154,9030,0.02602436323366556
703,8459,43,1231,335,10068,0.12226857369884783
704,532,2,71,37,642,0.11059190031152648
705,3507,8,150,221,3886,0.03860010293360782
706,2562,4,313,188,3067,0.10205412455167917
707,15683,14,202,859,16758,0.012053944384771453
708,6862,29,299,449,7639,0.03914124885456211
709,2684,5,59,192,2940,0.020068027210884354
710,16499,27,524,979,18029,0.02906428531809862
711,2567,6,406,143,3122,0.13004484304932734
712,3435,1,776,222,4434,0.17501127649977447
713,5631,10,371,522,6534,0.05677992041628405
714,1290,2,197,45,1534,0.12842242503259452
715,3948,11,313,157,4429,0.07067058026642584
716,1502,2,235,63,1802,0.13041065482796893
717,2177,8,558,140,2883,0.1935483870967742
718,2238,5,214,75,2532,0.08451816745655608
719,2451,8,124,134,2717,0.045638571954361426
720,728,3,117,53,901,0.12985571587125416
721,5313,12,269,446,6040,0.0445364238410596
722,1959,2,168,147,2276,0.07381370826010544
723,982,0,66,35,1083,0.060941828254847646
724,3894,1,290,263,4448,0.0651978417266187
725,4704,4,747,248,5703,0.13098369279326671
726,3207,4,217,211,3639,0.059631766968947515
727,3564,6,612,236,4418,0.13852421910366683
728,3612,14,441,244,4311,0.1022964509394572
729,6460,9,1620,701,8790,0.18430034129692832
730,7784,4,317,599,8704,0.036420036764705885
731,6225,18,628,295,7166,0.08763605916829473
732,2572,2,167,166,2907,0.057447540419676646
733,768,2,178,33,981,0.18144750254842
734,1922,7,120,104,2153,0.0557361820715281
735,1850,4,254,101,2209,0.11498415572657311
736,6407,12,355,285,7059,0.05029040940643151
737,1321,0,82,129,1532,0.05352480417754569
738,16049,19,1773,1605,19446,0.09117556309780932
739,7000,15,843,380,8238,0.1023306627822287
740,4611,14,1171,208,6004,0.19503664223850767
741,1220,4,148,108,1480,0.1
742,42130,112,4023,3341,49606,0.08109906059750836
743,3872,5,266,281,4424,0.060126582278481014
744,2754,7,166,213,3140,0.05286624203821656
745,4480,8,850,303,5641,0.15068250310228684
746,3777,11,279,284,4351,0.06412319007124799
747,15617,29,987,1582,18215,0.05418611034861378
748,3056,19,322,122,3519,0.0915032679738562
749,6101,7,471,669,7248,0.06498344370860927
750,2420,4,589,133,3146,0.18722186904005086
751,1518,9,50,162,1739,0.02875215641173088
752,5665,14,508,283,6470,0.078516228748068
753,2570,1,179,137,2887,0.06200207828195359
754,2822,3,497,132,3454,0.14389114070642733
755,7029,1,277,353,7660,0.036161879895561355
756,5253,14,299,277,5843,0.0511723429744994
757,4750,9,278,297,5334,0.05211848518935133
758,2195,8,192,120,2515,0.07634194831013917
759,34903,34,544,3858,39339,0.013828516230712525
760,8856,18,1499,412,10785,0.13898933704218822
761,2352,5,184,197,2738,0.06720233747260775
762,2380,6,39,109,2534,0.015390686661404893
763,2604,9,259,82,2954,0.08767772511848342
764,7305,2,92,240,7639,0.012043461186019112
765,7546,14,366,951,8877,0.04123014531936465
766,2698,1,155,131,2985,0.051926298157453935
767,2801,3,193,234,3231,0.05973382853605695
768,2909,3,414,146,3472,0.11923963133640553
769,997,1,214,47,1259,0.1699761715647339
770,2202,2,125,148,2477,0.050464271295922486
771,1251,3,48,120,1422,0.03375527426160337
772,556,3,44,21,624,0.07051282051282051
773,25346,29,1684,1054,28113,0.05990111336392416
774,24849,17,296,537,25699,0.011517957897194443
775,3895,8,328,255,4486,0.07311636201515827
776,1949,2,551,81,2583,0.21331784746418891
777,12707,16,952,563,14238,0.06686332350049164
778,7358,8,341,448,8155,0.04181483752299203
779,1145,3,123,57,1328,0.09262048192771084
780,36409,22,1039,3328,40798,0.025466934653659495
781,2316,3,126,101,2546,0.04948939512961508
782,5415,6,510,482,6413,0.07952596288788398
783,1453,2,153,129,1737,0.08808290155440414
784,1410,3,231,116,1760,0.13125
785,8730,17,213,705,9665,0.022038282462493532
786,12180,26,1832,894,14932,0.12268952585052237
787,1085,0,146,64,1295,0.11274131274131274
788,4896,8,510,352,5766,0.08844953173777315
789,9190,17,1031,530,10768,0.09574665676077267
790,56541,34,930,3371,60876,0.015276956436033905
791,16753,29,3543,1340,21665,0.16353565658896838
792,2816,10,141,154,3121,0.045177827619352774
793,32309,36,1177,2551,36073,0.03262828154021013
794,30153,41,1239,1268,32701,0.03788874957952356
795,5566,3,682,708,6959,0.09800258657853139
796,17155,40,1184,2992,21371,0.05540218052501053
797,2319,1,252,121,2693,0.09357593761604159
798,96551,179,7724,5680,110134,0.0701327473804638
799,2322,5,428,113,2868,0.1492329149232915
800,2330,4,329,151,2814,0.11691542288557213
801,53158,85,3429,4291,60963,0.05624723192756262
802,24253,12,294,528,25087,0.011719217124407063
803,16833,11,354,870,18068,0.019592649988930705
804,4161,13,1007,123,5304,0.18985671191553544
805,1132,3,105,86,1326,0.07918552036199095
806,38769,93,1378,2118,42358,0.03253222531753152
807,1155,0,82,74,1311,0.06254767353165523
808,4395,3,141,291,4830,0.029192546583850933
809,8224,12,487,657,9380,0.05191897654584222
810,6286,7,423,388,7104,0.05954391891891892
811,4667,11,283,352,5313,0.05326557500470544
812,4592,14,478,225,5309,0.09003578828404596
813,1016,1,113,45,1175,0.09617021276595744
814,2299,14,131,109,2553,0.05131218174696436
815,2006,1,301,110,2418,0.12448304383788254
816,17765,27,669,1653,20114,0.03326041563090385
817,6077,12,1369,337,7795,0.17562540089801154
818,4370,5,857,146,5378,0.15935291930085535
819,1593,0,63,95,1751,0.03597944031981725
820,3096,2,177,218,3493,0.050672774119667904
821,2665,3,319,116,3103,0.102803738317757
822,2778,5,440,120,3343,0.13161830690996112
823,11695,15,2717,371,14798,0.1836058926882011
824,2758,5,331,274,3368,0.09827790973871733
825,1895,7,99,89,2090,0.04736842105263158
826,7909,16,1375,304,9604,0.1431695127030404
827,2000,5,279,109,2393,0.11659005432511492
828,5049,5,46,368,5468,0.008412582297000731
829,14522,21,335,694,15572,0.021512972001027485
830,65301,59,1109,4100,70569,0.015715115702362226
831,8643,3,178,643,9467,0.018802154853702336
832,7463,7,299,583,8352,0.03579980842911877
833,1059,1,89,50,1199,0.07422852376980818
834,53124,74,2718,2800,58716,0.04629061925199264
835,3436,7,523,138,4104,0.1274366471734893
836,2533,6,182,101,2822,0.06449326718639263
837,1185,2,201,55,1443,0.1392931392931393
838,1257,6,31,86,1380,0.02246376811594203
839,1551,3,152,62,1768,0.08597285067873303
840,28256,22,1569,1597,31444,0.04989823177712759
841,8335,12,765,495,9607,0.07962943686894973
842,3283,12,300,267,3862,0.07767995857068877
843,7401,11,846,552,8810,0.0960272417707151
844,5633,10,766,332,6741,0.11363299213766503
845,4365,10,347,91,4813,0.07209640556825266
846,3328,1,573,141,4043,0.14172644076181054
847,7929,20,633,383,8965,0.07060791968767428
848,22807,42,2467,2036,27352,0.09019450131617432
849,4750,9,497,285,5541,0.0896950009023642
850,747,3,88,48,886,0.09932279909706546
851,2300,3,577,110,2990,0.19297658862876255
852,10054,9,268,629,10960,0.024452554744525547
853,3689,5,442,293,4429,0.09979679385865883
854,10884,28,853,1051,12816,0.06655742821473158
855,3756,13,193,254,4216,0.04577798861480076
856,2542,11,193,132,2878,0.06706045865184156
857,592,0,70,38,700,0.1
858,7054,10,199,447,7710,0.025810635538261996
859,56584,65,1300,3718,61667,0.021080967129907407
860,13715,9,575,811,15110,0.03805426869622766
861,4924,19,904,246,6093,0.14836697849991795
862,14809,17,1769,581,17176,0.102992547741034
863,16156,26,642,1059,17883,0.035900016775708775
864,2004,2,44,171,2221,0.01981089599279604
865,1680,6,115,108,1909,0.060240963855421686
866,3120,6,124,338,3588,0.03455964325529543
867,3361,5,174,252,3792,0.04588607594936709
868,1784,1,499,93,2377,0.20992848127892302
869,2479,3,201,165,2848,0.07057584269662921
870,538,0,89,20,647,0.1375579598145286
871,469,2,56,35,562,0.099644128113879
872,817,3,103,28,951,0.10830704521556257
873,1806,3,326,94,2229,0.14625392552714223
874,16462,19,1653,1053,19187,0.08615208213894825
875,2331,6,132,279,2748,0.048034934497816595
876,1304,3,140,66,1513,0.09253139458030403
877,7220,11,426,477,8134,0.05237275633144824
878,1054,2,187,96,1339,0.13965646004480955
879,2189,4,303,104,2600,0.11653846153846154
880,4435,4,191,213,4843,0.03943836465001033
881,2446,2,252,203,2903,0.08680675163623837
882,8998,7,1366,670,11041,0.12372067747486641
883,42931,24,981,1700,45636,0.021496187220615304
884,775,2,84,74,935,0.08983957219251337
885,3842,1,697,289,4829,0.14433630151170015
886,7046,5,669,291,8011,0.0835101735114218
887,12382,23,381,938,13724,0.027761585543573303
888,2228,2,226,230,2686,0.08413998510796723
889,4714,1,155,338,5208,0.02976190476190476
890,42559,111,1323,3041,47034,0.02812858783008037
891,3930,6,93,287,4316,0.02154772937905468
892,14875,22,2044,995,17936,0.1139607493309545
893,3222,16,290,165,3693,0.0785269428648795
894,2908,3,72,256,3239,0.022229083050324176
895,9378,7,599,967,10951,0.05469820107752717
896,1999,4,125,95,2223,0.05623031938821413
897,16393,27,2558,1485,20463,0.1250061085862288
898,2303,1,207,127,2638,0.07846853677028051
899,5377,18,1234,2757,9386,0.13147240571063284
900,2464,12,629,135,3240,0.1941358024691358
901,1767,1,310,74,2152,0.14405204460966542
902,1116,5,67,24,1212,0.05528052805280528
903,1622,8,175,83,1888,0.0926906779661017
904,2050,5,175,189,2419,0.07234394377842084
905,6341,0,257,300,6898,0.03725717599304146
906,18646,33,382,1496,20557,0.018582477988033273
907,9866,21,314,1221,11422,0.027490807214148136
908,1617,4,120,87,1828,0.06564551422319474
909,9835,10,1104,795,11744,0.09400544959128065
910,635,1,65,15,716,0.09078212290502793
911,6715,5,553,327,7600,0.07276315789473685
912,2776,9,143,182,3110,0.045980707395498394
913,4006,7,216,271,4500,0.048
914,3406,4,274,239,3923,0.06984450675503441
915,21004,13,631,1361,23009,0.02742405145812508
916,1991,2,64,101,2158,0.029657089898053754
917,2593,2,236,119,2950,0.08
918,731,0,93,46,870,0.10689655172413794
919,3736,5,93,281,4115,0.022600243013365735
920,1943,5,65,130,2143,0.03033131124591694
921,1344,8,92,74,1518,0.06060606060606061
922,3092,12,213,349,3666,0.05810147299509002
923,2335,2,233,131,2701,0.08626434653831914
924,26744,34,1471,1520,29769,0.049413819745372706
925,9608,30,1356,503,11497,0.11794381142906846
926,969,1,194,36,1200,0.16166666666666665
927,2860,7,274,116,3257,0.0841264967761744
928,4518,6,98,252,4874,0.020106688551497744
929,778,3,48,51,880,0.05454545454545454
930,6166,7,134,240,6547,0.020467389644111808
931,8624,7,145,539,9315,0.015566290928609769
932,2835,4,381,188,3408,0.11179577464788733
933,7565,3,425,564,8557,0.049666939347902304
934,11901,21,1595,559,14076,0.1133134413185564
935,3043,7,88,146,3284,0.02679658952496955
936,9599,4,2614,479,12696,0.20589161940768747
937,8703,15,545,578,9841,0.055380550757036885
938,2365,2,122,173,2662,0.04583020285499624
939,6633,10,990,440,8073,0.12263099219620958
940,4704,8,223,268,5203,0.04285988852585047
941,70548,50,881,1822,73301,0.012018935621614985
942,1819,3,290,123,2235,0.1297539149888143
943,2641,3,76,103,2823,0.026921714488133193
944,45533,62,2771,2592,50958,0.054378115310647984
945,463,3,23,25,514,0.04474708171206226
946,37958,60,2497,1367,41882,0.059619884437228404
947,15047,23,365,1123,16558,0.02204372508757096
948,22774,70,1422,1533,25799,0.05511841544245901
949,5940,7,153,396,6496,0.02355295566502463
950,2842,1,360,135,3338,0.10784901138406232
951,10272,33,1567,692,12564,0.12472142629735752
952,1040,1,187,69,1297,0.14417887432536622
953,1477,3,116,83,1679,0.06908874329958309
954,2502,5,287,176,2970,0.09663299663299663
955,3711,2,645,107,4465,0.1444568868980963
956,7149,9,386,761,8305,0.04647802528597231
957,9457,1,277,509,10244,0.027040218664584146
958,2959,2,158,136,3255,0.048540706605222736
959,1307,2,277,74,1660,0.16686746987951806
960,10497,11,797,878,12183,0.06541902651235328
961,1124,6,66,56,1252,0.052715654952076675
962,42689,71,6186,3185,52131,0.11866259998849053
963,9936,27,1064,419,11446,0.09295823868600385
964,24664,30,2243,1251,28188,0.07957286788704414
965,67815,90,5720,3137,76762,0.07451603658059977
966,23223,47,2428,1461,27159,0.08939946242497883
967,3980,5,390,261,4636,0.08412424503882658
968,12561,33,717,980,14291,0.05017143656846967
969,2600,7,303,224,3134,0.09668155711550734
970,4168,10,208,146,4532,0.04589585172109444
971,5961,5,375,615,6956,0.053910293271995396
972,1707,0,272,92,2071,0.1313375181071946
973,3671,9,216,224,4120,0.05242718446601942
974,18996,20,525,1289,20830,0.025204032645223237
975,2063,3,54,172,2292,0.02356020942408377
976,2209,2,354,98,2663,0.13293278257604205
977,6549,15,592,633,7789,0.07600462190268327
978,2621,6,238,138,3003,0.07925407925407925
979,3375,12,113,309,3809,0.029666579154633763
980,1927,6,77,102,2112,0.036458333333333336
981,8506,29,181,666,9382,0.01929226177787252
982,1184,3,129,43,1359,0.09492273730684327
983,14757,36,1209,436,16438,0.07354909356369388
984,9793,21,608,930,11352,0.053558844256518676
985,635,2,72,21,730,0.09863013698630137
986,2507,8,399,149,3063,0.13026444662095985
987,7408,6,1297,352,9063,0.1431093456912722
988,2895,0,154,116,3165,0.048657187993680885
989,1514,7,185,99,1805,0.10249307479224377
990,5237,6,443,299,5985,0.07401837928153718
991,19832,60,644,1718,22254,0.02893861777657949
992,2804,8,303,185,3300,0.09181818181818181
993,1614,1,132,63,1810,0.07292817679558011
994,3415,3,461,168,4047,0.11391153941191005
995,3198,5,244,294,3741,0.06522320235231222
996,2204,6,122,93,2425,0.05030927835051546
997,3677,4,276,378,4335,0.06366782006920416
998,2872,9,684,111,3676,0.18607181719260066
999,1091,1,95,48,1235,0.07692307692307693
1000,10499,14,959,781,12253,0.07826654696808945
1001,2410,2,196,116,2724,0.07195301027900147
1002,4774,14,386,222,5396,0.0715344699777613
1003,1894,2,173,125,2194,0.0788514129443938
1004,9356,14,337,729,10436,0.03229206592564201
1005,2311,4,305,136,2756,0.1106676342525399
1006,4421,11,447,233,5112,0.08744131455399061
1007,2284,3,166,139,2592,0.06404320987654322
1008,673,0,71,38,782,0.0907928388746803
1009,1596,3,125,54,1778,0.0703037120359955
1010,12205,16,4080,712,17013,0.23981661082701464
1011,15769,19,345,869,17002,0.020291730384660627
1012,5104,6,420,304,5834,0.07199177236887212
1013,9910,15,1040,465,11430,0.09098862642169729
1014,2213,2,175,139,2529,0.06919731119019375
1015,2845,2,388,150,3385,0.11462333825701625
1016,7580,11,282,404,8277,0.0340703153316419
1017,1515,7,118,124,1764,0.06689342403628118
1018,6107,11,234,507,6859,0.03411576031491471
1019,6003,5,941,484,7433,0.12659760527377908
1020,2945,18,232,173,3368,0.0688836104513064
1021,1999,12,88,184,2283,0.038545773105562856
1022,6593,10,728,763,8094,0.08994316777860144
1023,2626,6,135,181,2948,0.045793758480325644
1024,1721,1,103,207,2032,0.050688976377952756
1025,15120,21,1599,1042,17782,0.08992239343156
1026,3772,6,872,285,4935,0.17669706180344477
1027,3545,10,700,261,4516,0.1550044286979628
1028,2788,5,289,133,3215,0.08989113530326594
1029,7402,21,553,537,8513,0.06495947374603547
1030,441,1,54,16,512,0.10546875
1031,40325,98,2667,1109,44199,0.060340731690762234
1032,2742,4,231,124,3101,0.0744920993227991
1033,2246,5,180,143,2574,0.06993006993006994
1034,1780,5,92,98,1975,0.04658227848101266
1035,2424,4,237,135,2800,0.08464285714285714
1036,11442,10,627,851,12930,0.04849187935034803
1037,6057,6,1529,407,7999,0.19114889361170145
1038,10003,11,975,502,11491,0.08484901227047255
1039,1810,3,302,101,2216,0.13628158844765342
1040,6392,9,699,450,7550,0.09258278145695364
1041,2827,8,115,154,3104,0.03704896907216495
1042,2012,4,88,87,2191,0.040164308534915566
1043,124424,262,2484,10615,137785,0.01802808723736256
1044,12376,14,769,1302,14461,0.05317751192863564
1045,1501,1,189,63,1754,0.10775370581527936
1046,1470,6,114,100,1690,0.06745562130177515
1047,6278,6,123,469,6876,0.01788830715532286
1048,1040,0,52,35,1127,0.04614019520851819
1049,15594,18,2591,453,18656,0.1388829331046312
1050,6362,19,673,400,7454,0.09028709417762275
1051,1229,1,137,115,1482,0.09244264507422402
1052,2597,9,58,167,2831,0.020487460261391734
1053,925,1,156,71,1153,0.13529921942758022
1054,2815,8,142,137,3102,0.04577691811734365
1055,2801,10,523,131,3465,0.15093795093795093
1056,58467,86,5803,2823,67179,0.08638116077941023
1057,1242,3,94,83,1422,0.06610407876230662
1058,69670,50,1969,2741,74430,0.026454386672040843
1059,10308,13,351,578,11250,0.0312
1060,1496,2,195,191,1884,0.1035031847133758
1061,1253,1,184,86,1524,0.12073490813648294
1062,11405,34,556,367,12362,0.044976541012781104
1063,4686,4,198,269,5157,0.038394415357766144
1064,4740,12,446,238,5436,0.08204562178072111
1065,12447,10,1466,721,14644,0.10010925976509151
1066,2291,7,377,103,2778,0.13570914326853853
1067,10972,19,923,495,12409,0.07438149730034652
1068,3310,9,311,190,3820,0.08141361256544502
1069,4502,16,363,277,5158,0.0703761147731679
1070,3165,9,217,195,3586,0.06051310652537646
1071,2605,6,120,161,2892,0.04149377593360996
1072,1134,3,136,107,1380,0.09855072463768116
1073,7813,8,1086,1259,10166,0.10682667715915797
1074,5016,20,350,297,5683,0.06158718986450818
1075,6152,16,248,377,6793,0.036508170175180335
1076,8612,8,922,778,10320,0.08934108527131783
1077,13229,16,805,1460,15510,0.05190199871050935
1078,6518,12,160,578,7268,0.02201430930104568
1079,3771,13,165,274,4223,0.03907174994080038
1080,1173,2,114,76,1365,0.08351648351648351
1081,578,3,89,35,705,0.12624113475177304
1082,2440,2,436,69,2947,0.14794706481167288
1083,2102,4,118,181,2405,0.04906444906444907
1084,1939,5,275,90,2309,0.11909917713295799
1085,5859,7,480,312,6658,0.07209372183838991
1086,804,5,106,88,1003,0.10568295114656032
1087,70257,157,3945,3148,77507,0.0508986285109732
1088,3678,5,191,228,4102,0.04656265236470015
1089,1718,4,157,125,2004,0.0783433133732535
1090,21955,41,786,1091,23873,0.03292422401876597
1091,10049,22,848,863,11782,0.0719741979290443
1092,1969,6,212,135,2322,0.0913006029285099
1093,4345,24,321,247,4937,0.06501924245493214
1094,2450,4,243,141,2838,0.08562367864693446
1095,1149,0,173,78,1400,0.12357142857142857
1096,7129,48,440,458,8075,0.05448916408668731
1097,1127,2,141,39,1309,0.10771581359816654
1098,4625,8,205,350,5188,0.03951426368542791
1099,3077,6,249,148,3480,0.07155172413793104
1100,4896,3,517,273,5689,0.09087713130602917
1101,399,0,28,17,444,0.06306306306306306
1102,494723,299,12344,34008,541374,0.022801242763782523
1103,11260,27,1786,850,13923,0.12827695180636356
1104,11369,20,288,592,12269,0.02347379574537452
1105,1388,5,103,105,1601,0.06433479075577764
1106,7339,7,707,368,8421,0.08395677472984206
1107,1648,4,97,135,1884,0.05148619957537155
1108,5345,5,628,548,6526,0.09623046276432731
1109,1539,1,53,49,1642,0.03227771010962241
1110,2407,6,104,187,2704,0.038461538461538464
1111,3630,12,865,336,4843,0.1786083006400991
1112,2520,6,99,197,2822,0.03508150248051028
1113,38728,107,3772,2254,44861,0.08408194199861796
1114,5270,3,70,228,5571,0.012565069107880094
1115,11057,21,1190,667,12935,0.09199845380749903
1116,3513,10,617,203,4343,0.1420676951416072
1117,2371,7,404,108,2890,0.1397923875432526
1118,1414,5,97,68,1584,0.061237373737373736
1119,2883,4,121,216,3224,0.03753101736972705
1120,282,4,34,31,351,0.09686609686609686
1121,1445,2,373,95,1915,0.1947780678851175
1122,2421,4,279,199,2903,0.09610747502583535
1123,15556,34,642,1563,17795,0.03607754987355999
1124,2153,3,160,102,2418,0.06617038875103391
1125,7546,19,670,744,8979,0.07461855440472213
1126,31999,42,761,2491,35293,0.021562349474400024
1127,16148,44,644,1317,18153,0.03547622982427147
1128,2141,1,303,202,2647,0.11446921042689838
1129,4161,5,314,374,4854,0.06468891635764318
1130,3375,4,667,246,4292,0.1554054054054054
1131,50745,89,2079,2908,55821,0.03724404793894771
1132,1276,1,136,87,1500,0.09066666666666667
1133,18145,34,1307,1171,20657,0.06327153023188266
1134,17950,36,1466,1238,20690,0.0708554857419043
1135,3002,1,227,122,3352,0.06772076372315036
1136,13682,20,359,782,14843,0.02418648521188439
1137,8109,16,469,843,9437,0.049697997244887146
1138,108494,97,2437,5409,116437,0.02092977318206412
1139,20012,29,1007,1607,22655,0.044449348929596115
1140,13575,34,964,1315,15888,0.06067472306143001
1141,7597,14,195,600,8406,0.023197715917202
1142,4992,16,346,226,5580,0.06200716845878136
1143,2319,6,98,179,2602,0.03766333589546503
1144,4751,9,123,377,5260,0.02338403041825095
1145,4896,19,602,171,5688,0.10583684950773559
1146,4589,1,700,338,5628,0.12437810945273632
1147,1596,2,40,113,1751,0.022844089091947458
1148,886,1,379,66,1332,0.28453453453453453
1149,3536,4,341,298,4179,0.0815984685331419
1150,8090,4,571,307,8972,0.06364244315648684
1151,23950,50,814,1590,26404,0.03082866232389032
1152,1069,2,37,72,1180,0.03135593220338983
1153,709,4,41,34,788,0.05203045685279188
1154,7590,9,300,455,8354,0.035910940866650705
1155,1419,2,247,36,1704,0.1449530516431925
1156,7661,7,246,501,8415,0.02923351158645276
1157,8461,14,1357,511,10343,0.13119984530600406
1158,1741,8,73,153,1975,0.0369620253164557
1159,14214,7,1760,1046,17027,0.10336524343689435
1160,4797,12,92,312,5213,0.017648187224247075
1161,4182,8,211,278,4679,0.045095105791835864
1162,15754,10,995,774,17533,0.05675012832943592
1163,6894,17,509,543,7963,0.06392063292728871
1164,988,1,87,43,1119,0.0777479892761394
1165,4963,11,102,322,5398,0.018895887365690995
1166,12058,22,800,681,13561,0.05899269965341789
1167,1770,1,238,104,2113,0.1126360624704212
1168,11654,14,933,497,13098,0.07123224919835089
1169,5018,6,412,341,5777,0.07131729271248052
1170,1660,4,79,102,1845,0.042818428184281845
1171,17028,25,2039,1383,20475,0.09958485958485959
1172,6727,9,546,312,7594,0.071898867526995
1173,16338,35,1600,928,18901,0.08465160573514628
1174,798,1,45,104,948,0.04746835443037975
1175,11897,19,1330,706,13952,0.09532683486238532
1176,692,0,65,40,797,0.08155583437892096
1177,1390,1,106,62,1559,0.06799230275817832
1178,738,4,51,41,834,0.06115107913669065
1179,7957,9,178,626,8770,0.020296465222348917
1180,2604,7,126,124,2861,0.04404054526389374
1181,4118,4,333,271,4726,0.07046127803639442
1182,1260,3,158,69,1490,0.10604026845637583
1183,1612,0,155,81,1848,0.08387445887445888
1184,10487,29,606,531,11653,0.05200377585171201
1185,7074,15,1509,297,8895,0.16964586846543
1186,1465,6,128,55,1654,0.0773881499395405
1187,10944,22,682,711,12359,0.05518245812768023
1188,56064,43,1941,3203,61251,0.03168927854239115
1189,2634,6,298,163,3101,0.09609803289261529
1190,10488,32,1630,661,12811,0.12723440793068458
1191,590,1,43,41,675,0.0637037037037037
1192,4591,4,79,361,5035,0.015690168818272097
1193,4038,12,408,226,4684,0.08710503842869342
1194,1791,5,170,95,2061,0.08248423095584667
1195,1996,0,113,111,2220,0.0509009009009009
1196,3358,8,239,159,3764,0.06349628055260362
1197,1367,3,131,53,1554,0.08429858429858429
1198,1250,2,47,122,1421,0.033075299085151305
1199,12208,15,1249,896,14368,0.08692928730512249
1200,32697,48,11599,928,45272,0.25620692701890796
1201,4633,1,63,199,4896,0.012867647058823529
1202,3510,7,787,392,4696,0.1675894378194208
1203,38022,99,3807,1494,43422,0.0876744507392566
1204,1628,3,419,79,2129,0.19680601221230626
1205,5392,4,124,277,5797,0.0213903743315508
1206,3523,8,335,150,4016,0.08341633466135458
1207,6975,8,88,307,7378,0.01192735158579561
1208,1168,5,46,67,1286,0.03576982892690513
1209,1150,2,87,102,1341,0.06487695749440715
1210,2235,6,140,142,2523,0.055489496630994846
1211,7508,9,1092,492,9101,0.11998681463575431
1212,3602,8,448,284,4342,0.10317825886688162
1213,4272,3,183,350,4808,0.03806156405990017
1214,5099,8,544,296,5947,0.09147469312258281
1215,937,2,111,66,1116,0.09946236559139784
1216,5384,8,695,330,6417,0.10830606202275206
1217,7435,8,623,706,8772,0.07102143182854537
1218,48494,55,525,917,49991,0.010501890340261248
1219,6042,1,856,506,7405,0.11559756920999324
1220,989,1,86,38,1114,0.07719928186714542
1221,10693,3,408,505,11609,0.03514514600740805
1222,1167,4,130,41,1342,0.09687034277198212
1223,828,1,132,27,988,0.13360323886639677
1224,1693,4,198,79,1974,0.10030395136778116
1225,24115,19,426,1658,26218,0.016248378976275842
1226,338,1,42,10,391,0.10741687979539642
1227,2622,5,38,198,2863,0.013272790778903249
1228,11299,8,1990,484,13781,0.14440171250272113
1229,8304,6,236,497,9043,0.026097534004202144
1230,5145,12,434,302,5893,0.07364669947395215
1231,11623,18,513,726,12880,0.039829192546583854
1232,1501,2,100,175,1778,0.0562429696287964
1233,3882,6,316,153,4357,0.07252696809731467
1234,31295,22,300,1935,33552,0.00894134477825465
1235,2096,9,181,98,2384,0.0759228187919463
1236,24856,40,1464,1153,27513,0.053211209246538
1237,1528,5,109,103,1745,0.06246418338108883
1238,4307,6,217,282,4812,0.04509559434746467
1239,738,1,206,27,972,0.21193415637860083
1240,24089,31,931,1873,26924,0.03457881444064775
1241,6329,15,162,511,7017,0.023086789226165028
1242,20625,17,2569,1134,24345,0.1055247484082974
1243,7463,16,195,389,8063,0.024184546694778618
1244,9373,10,352,370,10105,0.03483424047501237
1245,5021,11,185,379,5596,0.03305932809149392
1246,3685,9,416,191,4301,0.09672169262962102
1247,2747,3,265,160,3175,0.08346456692913386
1248,1816,5,298,116,2235,0.13333333333333333
1249,5649,22,347,354,6372,0.05445699937225361
1250,22675,18,2027,1287,26007,0.07794055446610527
1251,12944,15,322,415,13696,0.02351051401869159
1252,4425,7,678,316,5426,0.12495392554367858
1253,46900,43,1041,3935,51919,0.020050463221556656
1254,5143,13,257,401,5814,0.04420364637082903
1255,3064,8,247,274,3593,0.06874478151962149
1256,12094,13,2903,721,15731,0.1845400800966245
1257,86836,138,4414,7806,99194,0.044498659193096354
1258,1624,2,87,114,1827,0.047619047619047616
1259,1211,2,95,77,1385,0.06859205776173286
1260,1344,6,55,83,1488,0.03696236559139785
1261,2066,2,89,70,2227,0.039964077233947015
1262,1699,5,363,75,2142,0.16946778711484595
1263,6576,11,436,322,7345,0.05936010891763104
1264,4666,0,354,217,5237,0.06759595188084781
1265,1718,3,194,103,2018,0.09613478691774034
1266,1269,3,176,74,1522,0.11563731931668857
1267,9749,3,118,425,10295,0.011461874696454589
1268,7620,5,429,267,8321,0.051556303328926814
1269,8383,14,905,498,9800,0.0923469387755102
1270,11142,17,433,608,12200,0.035491803278688526
1271,2416,9,244,206,2875,0.08486956521739131
1272,126155,230,3869,7758,138012,0.02803379416282642
1273,931,3,109,52,1095,0.09954337899543379
1274,4080,10,438,176,4704,0.09311224489795919
1275,1421,1,257,62,1741,0.1476163124641011
1276,3014,7,145,146,3312,0.043780193236714976
1277,40032,83,2398,2802,45315,0.052918459671190556
1278,2377,4,375,91,2847,0.13171759747102213
1279,1200,0,178,71,1449,0.12284334023464458
1280,4018,6,192,265,4481,0.042847578665476456
1281,3815,6,336,109,4266,0.07876230661040788
1282,1837,2,156,138,2133,0.07313642756680731
1283,8027,16,1034,878,9955,0.10386740331491713
1284,3111,3,309,238,3661,0.08440316853318765
1285,3869,15,158,293,4335,0.036447520184544405
1286,5778,14,255,180,6227,0.040950698570740324
1287,1308,7,77,84,1476,0.0521680216802168
1288,5369,11,619,312,6311,0.09808271272381557
1289,2350,7,138,178,2673,0.051627384960718295
1290,6450,17,306,760,7533,0.04062126642771804
1291,2363,8,199,160,2730,0.0728937728937729
1292,8093,10,159,632,8894,0.01787722059815606
1293,3109,7,140,246,3502,0.03997715591090805
1294,1247,1,91,74,1413,0.06440198159943383
1295,17189,8,686,1640,19523,0.03513804230907135
1296,4990,4,733,185,5912,0.1239851150202977
1297,2015,1,242,126,2384,0.10151006711409397
1298,9269,12,373,658,10312,0.03617145073700543
1299,3756,2,71,338,4167,0.017038636909047278
1300,888,1,87,45,1021,0.08521057786483839
1301,2384,8,179,158,2729,0.06559179186515207
1302,22956,61,559,1252,24828,0.02251490252940229
1303,2573,9,164,173,2919,0.05618362452894827
1304,24547,40,4744,944,30275,0.15669694467382328
1305,3627,7,379,205,4218,0.08985301090564249
1306,8045,1,88,223,8357,0.010530094531530454
1307,5378,6,765,264,6413,0.11928894433182598
1308,4401,2,665,196,5264,0.12632978723404256
1309,2435,2,286,188,2911,0.09824802473376847
1310,25580,47,2059,1636,29322,0.07022031239342473
1311,5578,6,487,511,6582,0.07398966879367973
1312,1276,7,89,101,1473,0.06042090970807875
1313,424,1,56,18,499,0.11222444889779559
1314,2314,5,66,170,2555,0.02583170254403131
1315,2416,1,48,242,2707,0.01773180642777983
1316,1710,6,209,91,2016,0.10367063492063493
1317,4966,11,349,372,5698,0.06124956124956125
1318,13353,6,649,861,14869,0.04364785795951308
1319,1876,2,121,92,2091,0.05786704925872788
1320,2195,0,301,175,2671,0.11269187570198427
1321,8691,7,175,521,9394,0.018628912071535022
1322,4116,11,541,161,4829,0.11203147649616899
1323,2092,0,211,56,2359,0.08944467994913098
1324,5011,7,227,362,5607,0.04048510790083824
1325,13695,7,505,1184,15391,0.032811383275940485
1326,20344,7,546,1095,21992,0.024827209894507093
1327,10025,5,331,635,10996,0.030101855220080027
1328,1122,6,71,55,1254,0.05661881977671451
1329,6036,20,201,372,6629,0.030321315432191884
1330,3324,11,289,267,3891,0.0742739655615523
1331,7257,8,1076,390,8731,0.12323903332951552
1332,5678,6,222,381,6287,0.035310959121997776
1333,1114,1,68,72,1255,0.054183266932270914
1334,1024,7,320,33,1384,0.23121387283236994
1335,505,1,38,24,568,0.06690140845070422
1336,2274,1,301,119,2695,0.11168831168831168
1337,15700,31,151,989,16871,0.008950269693556992
1338,10287,29,1342,956,12614,0.10638972570160139
1339,1880,1,158,135,2174,0.07267709291628335
1340,68722,172,4324,6669,79887,0.05412645361573222
1341,1538,4,314,73,1929,0.16277864178330742
1342,6200,21,342,354,6917,0.04944340031805696
1343,2435,4,55,151,2645,0.020793950850661626
1344,3555,7,165,233,3960,0.041666666666666664
1345,2541,3,250,235,3029,0.08253549026081215
1346,64251,43,5034,4344,73672,0.06832989466825931
1347,875,6,117,62,1060,0.11037735849056604
1348,4245,7,720,190,5162,0.13948082138705928
1349,2641,3,226,105,2975,0.07596638655462185
1350,8171,24,596,441,9232,0.0645580589254766
1351,316,0,28,21,365,0.07671232876712329
1352,18814,31,1550,1659,22054,0.07028203500498775
1353,6297,21,491,493,7302,0.06724185154752123
1354,1350,3,132,166,1651,0.07995154451847365
1355,1905,10,160,130,2205,0.07256235827664399
1356,13807,24,1869,772,16472,0.113465274405051
1357,9264,24,999,529,10816,0.09236316568047337
1358,4862,11,615,453,5941,0.10351792627503788
1359,6574,14,773,386,7747,0.09978056021685813
1360,1150,1,90,85,1326,0.06787330316742081
1361,2611,3,97,187,2898,0.03347135955831608
1362,11228,5,123,887,12243,0.010046557216368537
1363,1810,1,68,110,1989,0.03418803418803419
1364,23672,50,6117,1663,31502,0.19417814741921147
1365,8044,13,518,508,9083,0.05702961576571617
1366,5023,2,130,451,5606,0.023189439885836605
1367,1199,4,121,90,1414,0.08557284299858557
1368,1628,0,70,90,1788,0.039149888143176735
1369,15830,30,1944,2301,20105,0.09669236508331261
1370,10420,31,1993,475,12919,0.15426890626209458
1371,1023,8,87,27,1145,0.07598253275109171
1372,2180,4,311,130,2625,0.11847619047619047
1373,1182,3,116,93,1394,0.08321377331420372
1374,864,0,135,62,1061,0.12723845428840716
1375,1194,3,129,63,1389,0.09287257019438445
1376,3459,10,521,220,4210,0.12375296912114014
1377,2299,6,132,154,2591,0.05094558085681204
1378,1686,4,185,111,1986,0.0931520644511581
1379,6044,9,1345,294,7692,0.1748569942797712
1380,11705,15,343,947,13010,0.026364335126825518
1381,12484,2,1196,1426,15108,0.0791633571617686
1382,2103,5,104,107,2319,0.04484691677447176
1383,5706,13,342,539,6600,0.05181818181818182
1384,2542,9,300,207,3058,0.09810333551340746
1385,1415,2,53,69,1539,0.03443794671864847
1386,1872,3,98,169,2142,0.0457516339869281
1387,12750,12,2505,579,15846,0.15808405906853465
1388,704,4,78,25,811,0.09617755856966707
1389,8059,17,268,315,8659,0.030950456172768218
1390,4439,0,247,174,4860,0.050823045267489715
1391,1011,1,95,66,1173,0.08098891730605286
1392,2873,4,134,162,3173,0.04223132682004412
1393,328186,310,9485,25746,363727,0.02607725024537634
1394,3376,2,134,193,3705,0.03616734143049932
1395,983,0,76,72,1131,0.0671971706454465
1396,3289,11,151,285,3736,0.040417558886509636
1397,5388,4,91,401,5884,0.015465669612508498
1398,2957,4,358,173,3492,0.10252004581901489
1399,12329,37,917,585,13868,0.06612344966830112
1400,1243,1,47,67,1358,0.03460972017673049
1401,3166,8,104,211,3489,0.029807967899111495
1402,12963,19,283,1075,14340,0.019735006973500696
1403,7190,15,275,517,7997,0.0343878954607978
1404,5899,16,346,578,6839,0.05059219184091241
1405,2845,7,511,174,3537,0.14447271699180095
1406,2295,7,183,210,2695,0.0679035250463822
1407,8854,23,286,243,9406,0.030406123750797362
1408,1943,4,353,48,2348,0.15034071550255537
1409,2726,3,159,196,3084,0.05155642023346303
1410,14221,18,602,925,15766,0.03818343270328555
1411,10206,4,3394,521,14125,0.24028318584070796
1412,17375,25,767,1111,19278,0.0397862848843241
1413,2372,5,226,173,2776,0.0814121037463977
1414,2453,2,174,113,2742,0.06345733041575492
1415,1562,3,273,137,1975,0.13822784810126582
1416,949,2,60,96,1107,0.05420054200542006
1417,1349,0,114,68,1531,0.07446113651208361
1418,20693,33,632,943,22301,0.02833953634366172
1419,1767,0,227,134,2128,0.10667293233082707
1420,9849,6,1616,529,12000,0.13466666666666666
1421,3029,5,207,131,3372,0.06138790035587188
1422,4082,13,760,202,5057,0.150286731263595
1423,2043,5,305,111,2464,0.12378246753246754
1424,2685,3,279,110,3077,0.09067273318167046
1425,5377,20,500,427,6324,0.07906388361796332
1426,19425,56,3518,1340,24339,0.14454168207403756
1427,5663,10,499,391,6563,0.07603230230077708
1428,4185,9,349,230,4773,0.07311963125916614
1429,1494,2,163,54,1713,0.09515469935785172
1430,4882,10,157,444,5493,0.028581831421809575
1431,4888,8,264,206,5366,0.049198658218412225
1432,1996,6,176,124,2302,0.07645525629887055
1433,1129,3,111,51,1294,0.08578052550231839
1434,2852,4,214,230,3300,0.06484848484848485
1435,4803,15,617,219,5654,0.10912628227803325
1436,3124,9,417,217,3767,0.11069816830368993
1437,5504,14,552,332,6402,0.08622305529522024
1438,1065,4,53,58,1180,0.044915254237288135
1439,1739,5,103,101,1948,0.052874743326488706
1440,1118,0,133,22,1273,0.1044776119402985
1441,2774,3,455,110,3342,0.13614602034709755
1442,7661,16,282,1104,9063,0.031115524660708375
1443,3221,9,241,72,3543,0.06802145074795371
1444,4867,7,291,335,5500,0.05290909090909091
1445,5599,8,621,533,6761,0.09185031800029582
1446,14214,26,406,764,15410,0.0263465282284231
1447,1149,1,126,103,1379,0.09137055837563451
1448,2505,5,211,125,2846,0.0741391426563598
1449,1797,2,311,70,2180,0.1426605504587156
1450,1623,3,106,68,1800,0.058888888888888886
1451,3614,9,359,214,4196,0.0855576739752145
1452,5180,7,132,432,5751,0.022952529994783515
1453,4405,3,75,217,4700,0.015957446808510637
1454,8866,24,1019,700,10609,0.09605052314072957
1455,1402,4,70,59,1535,0.04560260586319218
1456,701,4,27,31,763,0.035386631716906945
1457,26179,8,221,783,27191,0.008127689308962524
1458,819,1,63,40,923,0.06825568797399784
1459,1651,2,274,102,2029,0.1350418925579103
1460,2531,13,185,211,2940,0.06292517006802721
1461,61979,73,5106,3241,70399,0.07252943933862697
1462,10445,23,2322,768,13558,0.17126419825933029
1463,1618,0,155,121,1894,0.08183738120380148
1464,5664,16,200,382,6262,0.031938677738741615
1465,3184,4,354,110,3652,0.09693318729463307
1466,3905,7,812,163,4887,0.16615510538162473
1467,7505,14,541,574,8634,0.06265925411165162
1468,2144,1,361,119,2625,0.13752380952380952
1469,14481,16,1201,917,16615,0.07228408065001504
1470,8475,32,910,527,9944,0.0915124698310539
1471,1471,0,84,67,1622,0.051787916152897656
1472,18454,37,1746,1045,21282,0.08204116154496757
1473,19642,23,539,1395,21599,0.024954859021250983
1474,1399,0,270,192,1861,0.14508328855454056
1475,5168,12,654,271,6105,0.10712530712530713
1476,3623,5,151,413,4192,0.036020992366412215
1477,2875,16,128,155,3174,0.04032766225582861
1478,238,0,40,10,288,0.1388888888888889
1479,1945,2,415,103,2465,0.16835699797160245
1480,126990,166,7650,15313,150119,0.05095957207282223
1481,7649,14,286,397,8346,0.03426791277258567
1482,6453,22,271,411,7157,0.03786502724605281
1483,2748,5,262,106,3121,0.08394745273950657
1484,2422,11,121,186,2740,0.04416058394160584
1485,25882,36,1431,938,28287,0.050588609608654155
1486,2391,4,161,141,2697,0.059695958472376714
1487,71039,173,2946,4132,78290,0.03762932686166816
1488,1670,2,261,64,1997,0.13069604406609914
1489,9028,18,1301,771,11118,0.11701744918150747
1490,3667,16,139,435,4257,0.03265210241954428
1491,4042,14,361,286,4703,0.07675951520306187
1492,5514,9,170,412,6105,0.027846027846027847
1493,950,3,78,73,1104,0.07065217391304347
1494,7631,27,963,312,8933,0.1078025299451472
1495,30923,80,930,2249,34182,0.027207302088818677
1496,1781,2,154,162,2099,0.07336827060505002
1497,5086,7,493,361,5947,0.08289894064234067
1498,753,3,52,70,878,0.05922551252847381
1499,6895,4,988,550,8437,0.11710323574730354
1500,18991,84,1729,1196,22000,0.07859090909090909
1501,82538,194,2898,5997,91627,0.03162823185305642
1502,7223,5,1054,348,8630,0.12213209733487833
1503,137867,144,1129,3421,142561,0.007919416951340129
1504,3014,0,470,216,3700,0.12702702702702703
1505,5575,1,546,368,6490,0.08412942989214175
1506,2211,3,202,114,2530,0.07984189723320158
1507,8169,17,1723,453,10362,0.1662806408029338
1508,567,1,33,20,621,0.05314009661835749
1509,2347,4,517,96,2964,0.17442645074224022
1510,3042,4,607,221,3874,0.15668559628291173
1511,3499,12,190,183,3884,0.04891864057672503
1512,13168,18,788,496,14470,0.05445749827228749
1513,2120,4,225,140,2489,0.09039775010044195
1514,4293,12,757,342,5404,0.14008142116950406
1515,2281,9,196,89,2575,0.07611650485436894
1516,5949,9,763,444,7165,0.10648988136775994
1517,5495,4,439,498,6436,0.06821006836544438
1518,628,2,81,67,778,0.10411311053984576
1519,3635,9,468,173,4285,0.10921820303383897
1520,5048,5,714,506,6273,0.11382113821138211
1521,3261,7,54,230,3552,0.015202702702702704
1522,8254,13,712,393,9372,0.07597097737942808
1523,4669,4,350,262,5285,0.06622516556291391
1524,5109,5,747,222,6083,0.12280124938352786
1525,4739,12,256,266,5273,0.04854921297174284
1526,8133,14,593,740,9480,0.06255274261603376
1527,4184,2,294,222,4702,0.06252658443215653
1528,4942,10,441,205,5598,0.07877813504823152
1529,890,1,119,30,1040,0.11442307692307692
1530,1739,2,140,71,1952,0.07172131147540983
1531,1920,4,83,156,2163,0.038372630605640314
1532,2766,5,523,246,3540,0.14774011299435028
1533,5582,8,828,368,6786,0.1220159151193634
1534,4728,9,162,202,5101,0.03175847872966085
1535,69327,234,9367,3050,81978,0.1142623630730196
1536,5411,19,751,575,6756,0.11116044997039669
1537,3474,6,236,282,3998,0.05902951475737869
1538,10248,26,827,839,11940,0.06926298157453936
1539,6091,17,184,600,6892,0.026697620429483458
1540,1451,4,173,85,1713,0.10099241097489783
1541,4675,9,642,246,5572,0.11521895190236899
1542,4560,10,266,368,5204,0.05111452728670254
1543,6382,9,204,396,6991,0.02918037476755829
1544,14329,33,931,920,16213,0.057423055572688585
1545,1557,0,52,124,1733,0.030005770340450086
1546,2098,3,106,194,2401,0.044148271553519365
1547,1730,2,177,98,2007,0.08819133034379671
1548,2151,3,270,81,2505,0.10778443113772455
1549,3304,5,324,228,3861,0.08391608391608392
1550,9886,12,171,688,10757,0.01589662545319327
1551,3195,4,461,148,3808,0.1210609243697479
1552,4507,9,395,252,5163,0.07650590741816773
1553,2482,0,98,205,2785,0.03518850987432675
1554,1244,2,209,91,1546,0.1351875808538163
1555,3128,11,218,238,3595,0.06063977746870654
1556,5825,11,757,366,6959,0.10877999712602385
1557,31348,67,2278,1550,35243,0.06463694918139773
1558,2728,0,346,114,3188,0.10853199498117942
1559,9632,6,230,668,10536,0.021829916476841307
1560,3437,7,151,277,3872,0.03899793388429752
1561,2163,5,106,188,2462,0.04305442729488221
1562,7123,11,714,394,8242,0.0866294588692065
1563,24445,43,1864,1422,27774,0.0671131273853244
1564,1298,1,75,59,1433,0.052337752965806
1565,7889,16,652,487,9044,0.07209199469261389
1566,15999,18,1302,832,18151,0.0717315850366371
1567,11197,17,262,687,12163,0.021540738304694565
1568,2515,1,104,126,2746,0.037873270211216316
1569,1819,1,87,213,2120,0.0410377358490566
1570,2375,2,150,250,2777,0.05401512423478574
1571,3397,7,312,211,3927,0.07944996180290298
1572,3485,3,202,187,3877,0.05210214083053907
1573,2215,7,408,80,2710,0.15055350553505534
1574,13410,10,2853,911,17184,0.16602653631284917
1575,1032,5,146,75,1258,0.11605723370429252
1576,4037,4,132,383,4556,0.02897278314310799
1577,1357,2,91,140,1590,0.057232704402515724
1578,3062,4,74,99,3239,0.022846557579499844
1579,8195,6,287,634,9122,0.031462398596798946
1580,26673,37,624,2510,29844,0.020908725371934056
1581,4027,4,904,212,5147,0.17563629298620556
1582,9579,16,390,314,10299,0.03786775415088844
1583,53008,39,2700,3738,59485,0.04538959401529798
1584,3089,5,128,260,3482,0.03676048248133257
1585,6399,7,443,256,7105,0.06235045742434905
1586,19106,49,1857,999,22011,0.08436690745536322
1587,817,2,68,30,917,0.07415485278080698
1588,5929,17,455,339,6740,0.06750741839762611
1589,1917,4,125,55,2101,0.05949547834364588
1590,550,0,24,27,601,0.03993344425956739
1591,6561,3,1028,234,7826,0.1313570150779453
1592,5540,18,435,407,6400,0.06796875
1593,1849,8,207,96,2160,0.09583333333333334
1594,4637,5,367,232,5241,0.07002480442663614
1595,112422,122,2143,3925,118612,0.018067311907732777
1596,1841,5,116,108,2070,0.05603864734299517
1597,3759,8,176,189,4132,0.04259438528557599
1598,20124,25,1238,1411,22798,0.05430300903588034
1599,46605,51,1225,1178,49059,0.024969934160908293
1600,18643,19,1438,824,20924,0.06872490919518257
1601,13513,20,1357,838,15728,0.08627924720244151
1602,11376,19,2763,636,14794,0.18676490469109097
1603,14648,33,358,1068,16107,0.022226361209412057
1604,1817,7,339,97,2260,0.15
1605,5245,1,668,334,6248,0.10691421254801536
1606,9346,4,217,453,10020,0.021656686626746507
1607,7009,7,221,373,7610,0.0290407358738502
1608,1287,5,171,48,1511,0.11317008603573792
1609,8533,9,2325,525,11392,0.20409058988764045
1610,1178,1,193,44,1416,0.1362994350282486
1611,1742,4,95,72,1913,0.04966021955044433
1612,6343,9,147,257,6756,0.021758436944937832
1613,3644,9,198,480,4331,0.04571692449780651
1614,3895,7,165,164,4231,0.038997872843299454
1615,4786,7,643,206,5642,0.11396667848280752
1616,3152,5,330,166,3653,0.0903367095537914
1617,57075,96,5152,2710,65033,0.07922131840757769
1618,64786,113,3773,2578,71250,0.05295438596491228
1619,3494,16,358,246,4114,0.08701993193971803
1620,1551,14,129,56,1750,0.07371428571428572
1621,1634,5,180,108,1927,0.0934094447327452
1622,569,3,31,15,618,0.05016181229773463
1623,18521,19,1162,567,20269,0.05732892594602595
1624,6873,12,70,542,7497,0.009337068160597572
1625,6690,10,487,381,7568,0.06434989429175475
1626,493,0,103,21,617,0.16693679092382496
1627,8432,6,538,650,9626,0.05589029711198836
1628,3715,4,107,217,4043,0.026465495918872126
1629,4408,4,75,231,4718,0.0158965663416702
1630,3878,6,665,270,4819,0.1379954347374974
1631,1019,5,47,79,1150,0.0408695652173913
1632,4215,3,180,308,4706,0.03824904377390565
1633,3922,9,152,199,4282,0.03549743110695937
1634,8018,6,375,370,8769,0.04276428327061239
1635,8459,16,193,768,9436,0.02045358202628232
1636,5058,5,480,365,5908,0.08124576844955991
1637,8994,21,1573,629,11217,0.14023357403940448
1638,3071,9,254,160,3494,0.0726960503720664
1639,2556,6,219,150,2931,0.07471852610030706
1640,4238,9,386,200,4833,0.07986757707428098
1641,24804,30,1884,1291,28009,0.06726409368417294
1642,4994,8,340,467,5809,0.0585298674470649
1643,5624,11,327,396,6358,0.05143126769424347
1644,13428,13,1866,744,16051,0.11625443897576475
1645,2647,6,394,178,3225,0.12217054263565892
1646,10529,17,169,484,11199,0.01509063309224038
1647,1611,4,270,118,2003,0.13479780329505742
1648,4072,17,343,209,4641,0.07390648567119155
1649,5019,7,217,399,5642,0.038461538461538464
1650,1124,3,104,137,1368,0.07602339181286549
1651,1441,3,299,46,1789,0.16713247624371158
1652,1083,4,28,60,1175,0.023829787234042554
1653,2036,7,302,124,2469,0.1223167274200081
1654,2362,8,634,109,3113,0.20366206231930614
1655,4617,5,102,202,4926,0.020706455542021926
1656,2266,0,83,86,2435,0.034086242299794664
1657,2069,7,142,161,2379,0.059688944934846576
1658,3188,13,111,244,3556,0.031214848143982003
1659,8430,30,840,384,9684,0.08674101610904585
1660,4299,5,127,230,4661,0.02724737180862476
1661,10698,23,900,803,12424,0.0724404378622022
1662,4405,4,159,237,4805,0.03309053069719042
1663,141598,232,5262,10698,157790,0.0333481209202104
1664,952,2,141,47,1142,0.1234676007005254
1665,4197,4,570,233,5004,0.11390887290167866
1666,7023,9,178,338,7548,0.023582405935347113
1667,6009,9,573,353,6944,0.08251728110599078
1668,6126,12,546,329,7013,0.07785541137886781
1669,13655,23,1154,1009,15841,0.07284893630452623
1670,2086,3,290,140,2519,0.11512504962286621
1671,2261,9,266,94,2630,0.10114068441064639
1672,4396,9,236,378,5019,0.047021318987846186
1673,7268,22,551,448,8289,0.06647363976354205
1674,76450,97,1712,3514,81773,0.02093600577207636
1675,12974,11,631,944,14560,0.04333791208791209
1676,1668,0,211,192,2071,0.10188314823756639
1677,15877,20,925,852,17674,0.05233676587077062
1678,4412,12,459,220,5103,0.08994708994708994
1679,59618,118,4044,3585,67365,0.060031173458027165
1680,9790,14,1557,899,12260,0.12699836867862968
1681,19968,14,319,1840,22141,0.014407659997290096
1682,7310,9,549,412,8280,0.06630434782608696
1683,489,0,63,24,576,0.109375
1684,1031,4,88,93,1216,0.07236842105263158
1685,795,3,137,46,981,0.1396534148827727
1686,1764,4,63,151,1982,0.031786074672048435
1687,41365,92,2621,2532,46610,0.05623256811842952
1688,4706,8,430,394,5538,0.07764535933550018
1689,2329,6,514,144,2993,0.17173404610758436
1690,1886,0,71,125,2082,0.034101825168107586
1691,15401,23,596,1207,17227,0.03459685377604922
1692,7465,17,330,717,8529,0.03869152303904327
1693,3743,9,101,189,4042,0.02498762988619495
1694,1021,1,77,51,1150,0.06695652173913043
1695,663,1,109,71,844,0.12914691943127962
1696,3849,3,505,247,4604,0.10968722849695917
1697,3736,6,129,465,4336,0.029750922509225092
1698,1990,7,274,147,2418,0.11331679073614558
1699,65649,81,1668,4984,72382,0.02304440330468901
1700,2575,3,417,148,3143,0.13267578746420616
1701,979,1,104,31,1115,0.09327354260089686
1702,1521,0,260,136,1917,0.1356285863328117
1703,14602,17,1287,951,16857,0.07634810464495462
1704,46751,92,1842,3042,51727,0.03561002957836333
1705,2223,2,192,159,2576,0.07453416149068323
1706,1139,1,126,50,1316,0.09574468085106383
1707,2106,5,240,102,2453,0.09783938035059112
1708,20856,50,1444,1658,24008,0.060146617794068644
1709,5021,10,555,234,5820,0.09536082474226804
1710,3620,8,590,151,4369,0.13504234378576332
1711,483,2,53,74,612,0.08660130718954248
1712,2576,7,164,163,2910,0.056357388316151204
1713,10667,11,670,422,11770,0.05692438402718777
1714,1567,7,73,105,1752,0.041666666666666664
1715,34698,43,7039,2320,44100,0.15961451247165534
1716,3145,8,225,154,3532,0.06370328425821065
1717,1245,4,65,75,1389,0.04679625629949604
1718,13812,17,906,1126,15861,0.05712124077926991
1719,22001,36,3798,1142,26977,0.14078659598917598
1720,2066,8,283,106,2463,0.11490052781161185
1721,23215,42,511,1452,25220,0.020261697065820778
1722,2138,5,262,200,2605,0.10057581573896353
1723,4029,9,178,239,4455,0.03995510662177329
1724,7096,27,744,263,8130,0.09151291512915129
1725,1456,1,260,71,1788,0.14541387024608501
1726,4705,3,1065,491,6264,0.1700191570881226
1727,35629,56,3556,2513,41754,0.08516549312640705
1728,23032,75,580,1849,25536,0.022713032581453633
1729,2316,3,84,109,2512,0.03343949044585987
1730,2324,5,321,222,2872,0.11176880222841226
1731,441,1,75,56,573,0.13089005235602094
1732,1506,2,166,96,1770,0.09378531073446328
1733,4077,6,480,366,4929,0.09738283627510651
1734,16981,16,253,1509,18759,0.013486859640705794
1735,4252,0,133,139,4524,0.029398762157382848
1736,13427,23,920,885,15255,0.060308095706325796
1737,13573,43,1105,652,15373,0.07187926884798022
1738,40242,41,846,2930,44059,0.019201525227535803
1739,17912,14,598,599,19123,0.03127124405166554
1740,1238,3,121,34,1396,0.08667621776504297
1741,19095,77,1488,1346,22006,0.06761792238480414
1742,42690,89,2717,2483,47979,0.05662894182871673
1743,13339,17,987,1008,15351,0.06429548563611491
1744,16726,35,2585,985,20331,0.12714573803551227
1745,5941,6,308,298,6553,0.047001373416755685
1746,12039,13,1023,788,13863,0.0737935511793984
1747,2821,4,171,189,3185,0.05368916797488226
1748,1410,3,78,156,1647,0.04735883424408015
1749,17431,31,2224,1212,20898,0.10642166714518135
1750,18390,12,352,987,19741,0.017830910288232613
1751,2559,0,404,81,3044,0.13272010512483573
1752,5904,5,1714,314,7937,0.21595061106211416
1753,1810,2,292,175,2279,0.12812637121544537
1754,11308,9,356,366,12039,0.029570562339064705
1755,2009,6,445,113,2573,0.1729498639720171
1756,4134,3,424,238,4799,0.08835173994582204
1757,7921,6,264,497,8688,0.03038674033149171
1758,2340,1,277,140,2758,0.10043509789702683
1759,1117,1,174,46,1338,0.13004484304932734
1760,78407,63,7820,3635,89925,0.08696135668612733
1761,2699,4,172,157,3032,0.05672823218997362
1762,2843,5,354,143,3345,0.10582959641255606
1763,3008,9,120,172,3309,0.03626473254759746
1764,1247,2,192,45,1486,0.12920592193808883
1765,16847,25,1633,1117,19622,0.08322291305677301
1766,19109,65,882,1207,21263,0.04148050604336171
1767,12188,8,111,170,12477,0.008896369319547967
1768,2738,3,165,280,3186,0.051789077212806026
1769,3535,11,151,340,4037,0.03740401288085212
1770,8893,12,486,522,9913,0.04902653081811762
1771,16240,26,373,1272,17911,0.020825191223270617
1772,2496,4,314,117,2931,0.10713067212555442
1773,927,0,73,76,1076,0.06784386617100371
1774,15147,31,328,1323,16829,0.01949016578525165
1775,4430,4,118,260,4812,0.024522028262676642
1776,7325,11,626,573,8535,0.07334504979496193
1777,1016,3,52,145,1216,0.04276315789473684
1778,2348,5,208,164,2725,0.0763302752293578
1779,3264,1,87,205,3557,0.024458813606972166
1780,3946,8,264,377,4595,0.05745375408052231
1781,19870,46,3823,824,24563,0.15564059764686725
1782,971,4,81,85,1141,0.07099035933391762
1783,32414,67,4470,2287,39238,0.1139201794179112
1784,16491,25,1634,972,19122,0.08545131262420248
1785,11610,24,923,627,13184,0.07000910194174757
1786,11036,29,933,503,12501,0.07463402927765779
1787,1426,1,165,51,1643,0.10042604990870359
1788,3915,6,456,277,4654,0.09798023205844435
1789,4962,6,154,293,5415,0.028439519852262233
1790,1425,2,31,130,1588,0.01952141057934509
1791,1923,3,128,29,2083,0.061449831973115696
1792,1968,2,143,124,2237,0.06392489941886455
1793,1090,2,110,82,1284,0.08566978193146417
1794,1541,4,131,98,1774,0.07384441939120631
1795,1012,4,120,70,1206,0.09950248756218906
1796,9561,30,592,529,10712,0.05526512322628827
1797,1751,5,91,169,2016,0.04513888888888889
1798,808,1,78,27,914,0.08533916849015317
1799,1583,3,158,121,1865,0.08471849865951743
1800,5355,4,389,214,5962,0.06524656155652465
1801,1850,2,280,63,2195,0.1275626423690205
1802,3933,7,283,149,4372,0.06473010064043916
1803,1219,2,147,86,1454,0.10110041265474554
1804,2153,5,324,95,2577,0.12572759022118743
1805,27109,50,9274,1410,37843,0.24506513754194964
1806,9376,20,337,797,10530,0.032003798670465336
1807,9567,44,717,696,11024,0.0650399129172714
1808,2158,8,175,153,2494,0.07016840417000803
1809,1476,7,318,55,1856,0.1713362068965517
1810,62300,48,1284,3577,67209,0.019104584207472214
1811,2821,1,701,209,3732,0.18783494105037513
1812,965,0,199,46,1210,0.16446280991735537
1813,861,3,91,56,1011,0.09000989119683482
1814,3655,6,140,485,4286,0.032664489034064395
1815,71959,89,1670,4412,78130,0.021374632023550492
1816,42048,201,2818,2078,47145,0.05977304061936579
1817,617,1,21,39,678,0.030973451327433628
1818,4593,8,393,275,5269,0.07458720819889922
1819,4546,9,576,281,5412,0.10643015521064302
1820,1902,2,100,123,2127,0.047014574518100614
1821,2131,0,452,106,2689,0.16809222759390108
1822,23665,17,684,1835,26201,0.02610587382160986
1823,2632,7,336,172,3147,0.10676835081029552
1824,6987,12,3001,255,10255,0.29263773768893225
1825,2973,7,313,126,3419,0.09154723603392804
1826,4473,5,171,350,4999,0.034206841368273656
1827,6418,13,222,299,6952,0.03193325661680092
1828,3806,7,533,315,4661,0.11435314310233856
1829,1800,0,168,124,2092,0.08030592734225621
1830,3290,5,417,232,3944,0.10573022312373224
1831,9188,10,1557,790,11545,0.13486357730619317
1832,2400,3,142,156,2701,0.05257312106627175
1833,49548,91,2715,1231,53585,0.050667164318372676
1834,7970,6,563,631,9170,0.0613958560523446
1835,22630,18,294,991,23933,0.012284293653114946
1836,3908,5,95,247,4255,0.022326674500587545
1837,3468,6,744,121,4339,0.1714680802028117
1838,8619,8,1725,469,10821,0.1594122539506515
1839,5062,4,216,353,5635,0.03833185448092281
1840,15354,50,3435,560,19399,0.1770709830403629
1841,20504,20,395,1340,22259,0.017745630980726897
1842,1306,5,176,76,1563,0.1126039667306462
1843,5976,5,150,339,6470,0.023183925811437404
1844,9721,22,387,2785,12915,0.029965156794425088
1845,2654,4,489,253,3400,0.1438235294117647
1846,931,0,112,42,1085,0.1032258064516129
1847,2235,2,265,193,2695,0.09833024118738404
1848,7139,2,121,398,7660,0.015796344647519583
1849,4536,9,431,262,5238,0.08228331424207713
1850,8202,19,517,271,9009,0.057387057387057384
1851,5293,12,792,309,6406,0.12363409303777709
1852,4001,3,538,293,4835,0.11127197518097208
1853,3525,2,459,200,4186,0.10965121834687053
1854,9159,19,575,1193,10946,0.05253060478713685
1855,6611,8,307,507,7433,0.04130230055159424
1856,652,0,164,34,850,0.19294117647058823
1857,1829,0,133,137,2099,0.06336350643163412
1858,6149,18,791,344,7302,0.10832648589427554
1859,541,4,61,33,639,0.09546165884194054
1860,38377,49,4488,2322,45236,0.0992130161818021
1861,52094,120,7109,3911,63234,0.11242369611285068
1862,7331,6,855,328,8520,0.10035211267605634
1863,1536,6,148,123,1813,0.08163265306122448
1864,4501,3,221,495,5220,0.042337164750957855
1865,2391,2,252,130,2775,0.09081081081081081
1866,11303,5,562,763,12633,0.04448666191720098
1867,27233,40,5223,1837,34333,0.15212769056010253
1868,7647,13,198,576,8434,0.02347640502727057
1869,1724,0,134,54,1912,0.0700836820083682
1870,3063,5,333,270,3671,0.09071097793516752
1871,1683,5,169,69,1926,0.0877466251298027
1872,3069,5,209,388,3671,0.05693271588123127
1873,997,1,92,48,1138,0.08084358523725835
1874,25665,79,1402,2252,29398,0.047690319069324444
1875,61385,100,5326,2200,69011,0.07717610236049326
1876,2102,10,77,184,2373,0.032448377581120944
1877,4343,5,118,215,4681,0.025208288827173683
1878,9110,17,1067,927,11121,0.09594460929772503
1879,2297,13,164,320,2794,0.05869720830350752
1880,1225,4,65,68,1362,0.04772393538913363
1881,5522,6,103,156,5787,0.017798513910489026
1882,3335,11,395,279,4020,0.09825870646766169
1883,1903,7,166,255,2331,0.07121407121407121
1884,19959,57,1903,866,22785,0.08351985955672592
1885,24333,42,1197,1963,27535,0.043471944797530415
1886,5249,5,466,239,5959,0.07820104044302735
1887,12029,33,746,711,13519,0.0551815962719136
1888,3480,7,155,209,3851,0.04024928589976629
1889,2641,3,141,98,2883,0.04890738813735692
1890,99388,157,2524,7075,109144,0.023125412299347652
1891,2525,9,283,186,3003,0.09423909423909424
1892,130754,254,11265,5098,147371,0.0764397337332311
1893,813,0,148,61,1022,0.14481409001956946
1894,2834,3,111,227,3175,0.03496062992125984
1895,9836,45,1254,595,11730,0.10690537084398977
1896,1357,0,37,103,1497,0.024716098864395457
1897,6817,9,683,832,8341,0.0818846661071814
1898,1281,2,103,47,1433,0.0718771807397069
1899,4271,12,775,226,5284,0.14666919000757003
1900,7242,29,1108,291,8670,0.12779700115340253
1901,18722,21,1132,801,20676,0.05474946798220159
1902,1759,6,140,97,2002,0.06993006993006994
1903,4282,12,366,131,4791,0.07639323731997495
1904,7808,19,258,308,8393,0.030739902299535327
1905,3112,3,361,293,3769,0.09578137436985938
1906,3143,5,132,184,3464,0.03810623556581986
1907,6767,0,118,328,7213,0.01635935117149591
1908,8622,17,1429,263,10331,0.1383215564804956
1909,393,1,102,20,516,0.19767441860465115
1910,30255,31,1122,3090,34498,0.032523624557945385
1911,12353,28,791,757,13929,0.056787996266781535
1912,2544,5,202,145,2896,0.06975138121546962
1913,11461,23,818,581,12883,0.06349452767212606
1914,4017,6,543,165,4731,0.11477488902980343
1915,1465,4,148,121,1738,0.08515535097813579
1916,19756,59,3013,1016,23844,0.12636302633786278
1917,3510,6,366,354,4236,0.08640226628895184
1918,11425,16,370,1045,12856,0.028780336029869322
1919,5123,12,192,565,5892,0.032586558044806514
1920,2887,5,250,210,3352,0.07458233890214797
1921,12964,8,331,708,14011,0.02362429519663122
1922,3074,9,374,269,3726,0.10037573805689748
1923,15062,41,1770,805,17678,0.10012444846702116
1924,943,2,111,74,1130,0.09823008849557523
1925,1302,0,168,90,1560,0.1076923076923077
1926,4895,3,116,281,5295,0.021907459867799812
1927,3143,12,151,260,3566,0.04234436343241727
1928,3092,2,78,178,3350,0.023283582089552238
1929,2723,11,637,168,3539,0.1799943486860695
1930,1059,3,70,153,1285,0.054474708171206226
1931,7172,0,155,690,8017,0.019333915429711863
1932,3222,4,216,143,3585,0.0602510460251046
1933,2723,1,175,185,3084,0.05674448767833982
1934,3449,2,337,117,3905,0.08629961587708067
1935,1246,1,54,76,1377,0.0392156862745098
1936,1603,1,143,84,1831,0.0780993992353905
1937,2190,5,140,158,2493,0.05615724027276374
1938,1632,9,75,67,1783,0.04206393718452047
1939,3831,3,508,357,4699,0.10810810810810811
1940,5008,3,594,249,5854,0.10146908097027674
1941,4952,2,416,188,5558,0.07484706729039223
1942,1297,7,100,90,1494,0.06693440428380187
1943,4827,16,575,221,5639,0.10196843411952473
1944,6858,14,711,279,7862,0.09043500381582295
1945,32797,3,669,1258,34727,0.01926454919803035
1946,8303,16,1107,551,9977,0.11095519695299189
1947,1608,0,60,89,1757,0.03414911781445646
1948,10160,11,802,558,11531,0.06955164339606279
1949,20569,50,1486,1737,23842,0.06232698599110813
1950,5486,18,155,341,6000,0.025833333333333333
1951,4261,4,110,250,4625,0.023783783783783784
1952,13946,21,654,1052,15673,0.04172781216104128
1953,48269,58,1223,3874,53424,0.022892333033842468
1954,1720,2,280,84,2086,0.1342281879194631
1955,16199,16,683,1209,18107,0.0377202186999503
1956,1967,6,121,96,2190,0.055251141552511415
1957,12172,12,670,999,13853,0.048364975095647154
1958,1292,4,114,122,1532,0.07441253263707572
1959,3029,2,347,155,3533,0.098216812906878
1960,5612,3,307,410,6332,0.04848389134554643
1961,4508,13,830,451,5802,0.14305411926921752
1962,5805,7,257,515,6584,0.03903402187120292
1963,57321,54,1497,1553,60425,0.02477451386015722
1964,14354,28,2177,771,17330,0.1256203115983843
1965,541,0,57,20,618,0.09223300970873786
1966,7976,9,558,765,9308,0.05994843145681134
1967,61479,37,1122,2188,64826,0.017307870298954125
1968,9734,15,2240,433,12422,0.18032522943165352
1969,3198,6,177,247,3628,0.048787210584343994
1970,3003,20,598,112,3733,0.1601928743637825
1971,2109,10,27,85,2231,0.012102196324518153
1972,1184,5,138,57,1384,0.09971098265895954
1973,21204,11,210,1664,23089,0.009095240157650829
1974,14948,29,412,1306,16695,0.024678047319556754
1975,3633,7,559,171,4370,0.12791762013729976
1976,7766,20,751,430,8967,0.08375153340024534
1977,3573,2,657,248,4480,0.14665178571428572
1978,13712,49,1444,680,15885,0.09090336795719232
1979,4403,8,987,926,6324,0.15607210626185958
1980,2145,2,55,108,2310,0.023809523809523808
1981,6682,16,322,517,7537,0.04272256866127106
1982,1119,0,52,62,1233,0.042173560421735604
1983,6443,10,836,257,7546,0.11078717201166181
1984,25513,24,365,2255,28157,0.012963028731754093
1985,1785,8,77,92,1962,0.03924566768603466
1986,30957,38,2753,1594,35342,0.0778959877765831
1987,4939,6,518,367,5830,0.0888507718696398
1988,9922,7,1405,510,11844,0.11862546437014522
1989,12429,20,266,604,13319,0.019971469329529243
1990,780,0,66,88,934,0.07066381156316917
1991,1350,2,172,31,1555,0.11061093247588424
1992,12880,0,123,799,13802,0.008911751920011592
1993,10199,26,475,752,11452,0.04147747118407265
1994,846,2,62,42,952,0.06512605042016807
1995,1561,6,116,86,1769,0.06557377049180328
1996,6249,6,479,564,7298,0.06563442038914771
1997,4255,4,669,275,5203,0.1285796655775514
1998,45792,158,1362,2908,50220,0.027120669056152926
1999,11891,14,1372,459,13736,0.09988351776354105
2000,5020,4,203,559,5786,0.03508468717594193
2001,1388,1,211,94,1694,0.12455726092089728
2002,11579,23,755,1097,13454,0.05611713988404935
2003,1790,6,224,122,2142,0.10457516339869281
2004,3132,0,90,190,3412,0.02637749120750293
2005,1761,5,171,109,2046,0.08357771260997067
2006,2882,6,460,126,3474,0.13241220495106507
2007,823,3,104,50,980,0.10612244897959183
2008,9237,12,531,503,10283,0.0516386268598658
2009,9644,14,527,800,10985,0.04797451069640419
2010,2749,4,196,124,3073,0.06378132118451026
2011,7244,14,231,362,7851,0.02942300343905235
2012,1707,5,203,123,2038,0.09960745829244357
2013,4430,8,103,381,4922,0.02092645266151971
2014,25581,29,1083,1682,28375,0.038167400881057266
2015,468,2,47,22,539,0.08719851576994433
2016,5538,7,608,394,6547,0.09286696196731327
2017,2714,4,381,182,3281,0.11612313319110028
2018,9130,5,1596,526,11257,0.1417784489650884
2019,406,1,49,12,468,0.1047008547008547
2020,7109,18,834,328,8289,0.10061527325370974
2021,5707,4,755,396,6862,0.11002623141941124
2022,3584,17,114,201,3916,0.029111338100102146
2023,23087,43,1395,1187,25712,0.054254822650902305
2024,5020,6,461,398,5885,0.07833474936278674
2025,1510,3,110,87,1710,0.06432748538011696
2026,9002,42,816,518,10378,0.07862786664097128
2027,633,2,71,42,748,0.09491978609625669
2028,916,2,99,35,1052,0.094106463878327
2029,6997,10,844,525,8376,0.10076408787010506
2030,5082,10,340,293,5725,0.059388646288209605
2031,40267,73,5221,1889,47450,0.11003161222339304
2032,8276,8,334,491,9109,0.03666703260511582
2033,1131,0,157,80,1368,0.11476608187134503
2034,6846,14,687,328,7875,0.08723809523809524
2035,2681,12,199,165,3057,0.06509649983644096
2036,16543,37,2145,732,19457,0.11024310016960477
2037,9893,12,472,904,11281,0.041840262388086163
2038,398,0,15,21,434,0.03456221198156682
2039,1296,3,145,88,1532,0.09464751958224543
2040,1378,2,44,43,1467,0.029993183367416496
2041,2325,4,348,299,2976,0.11693548387096774
2042,10479,11,168,963,11621,0.014456587212804406
2043,3417,6,353,190,3966,0.08900655572365103
2044,3396,6,67,110,3579,0.018720312936574463
2045,2830,2,84,301,3217,0.02611128380478707
2046,5201,6,217,287,5711,0.03799684818770793
2047,29812,22,1420,2067,33321,0.042615767834098615
2048,2825,3,327,140,3295,0.0992412746585736
2049,37638,64,1148,2944,41794,0.02746805761592573
2050,6304,14,930,427,7675,0.12117263843648209
2051,17525,34,2317,1280,21156,0.10951975798827755
2052,3813,13,293,404,4523,0.06478001326553173
2053,2774,5,85,154,3018,0.028164347249834326
2054,4438,7,418,907,5770,0.07244367417677643
2055,3830,4,248,296,4378,0.05664687071722248
2056,3207,4,127,318,3656,0.034737417943107224
2057,316,3,39,18,376,0.10372340425531915
2058,2873,5,241,301,3420,0.07046783625730994
2059,1418,5,74,112,1609,0.04599129894344313
2060,2661,4,322,193,3180,0.10125786163522013
2061,3059,4,344,218,3625,0.09489655172413793
2062,51592,30,1272,4738,57632,0.02207107162687396
2063,629,0,65,22,716,0.09078212290502793
2064,23543,56,1740,1456,26795,0.06493748833737638
2065,7891,8,276,436,8611,0.032052026477761
2066,23343,25,1306,1565,26239,0.04977323830938679
2067,498,2,107,36,643,0.16640746500777606
2068,2782,1,197,238,3218,0.061218147917961464
2069,2799,7,226,201,3233,0.06990411382616765
2070,2838,13,149,164,3164,0.04709228824273072
2071,3122,3,235,162,3522,0.06672345258375922
2072,6069,15,404,438,6926,0.05833092694195784
2073,1492,1,144,63,1700,0.08470588235294117
2074,10428,18,1055,597,12098,0.08720449661101008
2075,4439,2,418,274,5133,0.08143385934151569
2076,21739,46,877,1245,23907,0.036683816455431464
2077,4441,9,758,273,5481,0.13829593139937968
2078,3857,9,431,287,4584,0.09402268760907505
2079,10781,6,1002,392,12181,0.08225925621870125
2080,1262,1,35,68,1366,0.02562225475841874
2081,9982,14,600,470,11066,0.054220133742996564
2082,18251,43,412,1194,19900,0.020703517587939698
2083,3989,18,375,206,4588,0.08173496076721883
2084,17652,35,2121,1147,20955,0.10121689334287759
2085,7730,14,147,393,8284,0.017745050700144857
2086,4255,4,191,323,4773,0.0400167609469935
2087,6262,15,710,428,7415,0.09575185434929198
2088,5383,6,658,239,6286,0.10467706013363029
2089,2383,10,140,289,2822,0.04961020552799433
2090,6352,6,1034,297,7689,0.13447782546494993
2091,4536,3,542,410,5491,0.09870697505008195
2092,3242,6,422,132,3802,0.1109942135718043
2093,2560,5,363,125,3053,0.11889944317065182
2094,11582,11,1141,675,13409,0.08509210231933775
2095,7769,21,954,405,9149,0.10427369111378293
2096,4832,11,629,312,5784,0.10874827109266944
2097,1095,0,64,57,1216,0.05263157894736842
2098,1940,4,31,75,2050,0.015121951219512195
2099,20949,74,3097,1087,25207,0.12286269686991709
2100,3404,7,139,148,3698,0.03758788534342888
2101,18746,21,301,1116,20184,0.014912802219579866
2102,9138,33,1393,460,11024,0.12636066763425255
2103,14142,35,752,683,15612,0.04816807583909813
2104,9834,6,1397,595,11832,0.11806964164976336
2105,2839,8,124,313,3284,0.037758830694275276
2106,19597,29,3726,989,24341,0.15307505854319872
2107,5185,5,115,290,5595,0.020554066130473638
2108,12731,66,1769,721,15287,0.11571923856871852
2109,712,0,118,44,874,0.13501144164759726
2110,1166,4,55,108,1333,0.04126031507876969
2111,3444,12,72,243,3771,0.01909307875894988
2112,1714,2,449,90,2255,0.19911308203991132
2113,5987,19,212,531,6749,0.0314120610460809
2114,3891,5,267,145,4308,0.06197771587743733
2115,1553,2,345,154,2054,0.1679649464459591
2116,44622,113,1547,3893,50175,0.03083208769307424
2117,908,2,75,49,1034,0.0725338491295938
2118,2281,2,399,104,2786,0.14321608040201006
2119,7563,17,534,358,8472,0.06303116147308782
2120,3507,8,298,124,3937,0.07569215138430277
2121,1482,6,135,62,1685,0.08011869436201781
2122,4482,17,497,327,5323,0.0933684012774751
2123,3763,7,223,552,4545,0.04906490649064906
2124,58926,53,1821,3474,64274,0.02833182935557146
2125,12302,26,1383,921,14632,0.09451886276653909
2126,2366,0,223,114,2703,0.08250092489826119
2127,1789,0,215,83,2087,0.1030186871106852
2128,10170,41,1691,925,12827,0.13183129336555702
2129,802,1,86,37,926,0.09287257019438445
2130,1680,7,269,155,2111,0.12742775935575557
2131,751,2,88,31,872,0.10091743119266056
2132,5823,4,143,328,6298,0.02270562083201016
2133,3116,4,275,146,3541,0.07766167749223384
2134,7356,9,186,374,7925,0.023470031545741326
2135,890,0,38,38,966,0.039337474120082816
2136,18185,33,732,809,19759,0.0370464092312364
2137,6538,9,216,363,7126,0.03031153522312658
2138,35586,88,5698,2039,43411,0.13125705466356452
2139,6013,14,213,331,6571,0.03241515751027241
2140,12696,59,885,532,14172,0.06244707874682472
2141,4182,8,374,228,4792,0.07804674457429048
2142,3014,2,269,128,3413,0.07881629065338412
2143,3980,0,602,355,4937,0.12193639862264533
2144,1375,5,185,99,1664,0.11117788461538461
2145,3656,2,327,167,4152,0.078757225433526
2146,3884,2,491,309,4686,0.1047801963294921
2147,3486,10,91,248,3835,0.023728813559322035
2148,4649,10,612,206,5477,0.11174000365163411
2149,10886,47,592,836,12361,0.0478925653264299
2150,2104,6,233,141,2484,0.09380032206119163
2151,9887,18,311,322,10538,0.029512241412032642
2152,9193,7,384,801,10385,0.03697640828117477
2153,2631,0,46,191,2868,0.01603905160390516
2154,2657,2,509,144,3312,0.15368357487922704
2155,1388,1,125,75,1589,0.07866582756450598
2156,10212,18,1050,790,12070,0.08699254349627175
2157,2958,3,241,114,3316,0.07267792521109771
2158,7009,10,888,281,8188,0.1084513922813874
2159,7557,7,249,337,8150,0.030552147239263805
2160,723,0,130,23,876,0.14840182648401826
2161,5906,6,354,249,6515,0.054336147352264004
2162,7854,11,499,822,9186,0.05432179403440018
2163,8060,9,1090,356,9515,0.11455596426694692
2164,2847,14,161,180,3202,0.05028107432854466
2165,3038,4,735,193,3970,0.18513853904282115
2166,2194,3,519,196,2912,0.17822802197802198
2167,5893,14,433,433,6773,0.06393031153107928
2168,27259,39,453,1798,29549,0.015330468036143356
2169,1166,1,49,54,1270,0.03858267716535433
2170,1882,3,322,75,2282,0.1411042944785276
2171,11855,22,271,570,12718,0.021308381821041045
2172,1982,3,268,107,2360,0.1135593220338983
2173,58986,92,4675,2557,66310,0.07050218669883879
2174,5093,10,283,310,5696,0.049683988764044944
2175,21789,29,1154,2613,25585,0.04510455344928669
2176,16430,30,914,797,18171,0.05029992845743217
2177,1515,4,294,53,1866,0.15755627009646303
2178,1904,0,97,180,2181,0.044475011462631824
2179,30879,42,123,1863,32907,0.0037378065457197556
2180,4562,6,345,279,5192,0.06644838212634822
2181,15015,24,865,787,16691,0.051824336468755616
2182,2459,2,125,152,2738,0.045653761869978084
2183,1798,2,359,90,2249,0.1596265006669631
2184,1653,4,277,62,1996,0.13877755511022044
2185,345,1,42,15,403,0.10421836228287841
2186,3822,0,52,196,4070,0.012776412776412777
2187,5689,13,188,277,6167,0.03048483865736987
2188,3216,5,270,232,3723,0.072522159548751
2189,2132,4,194,136,2466,0.0786699107866991
2190,1412,0,164,95,1671,0.09814482345900659
2191,1813,9,525,146,2493,0.21058965102286403
2192,5678,4,952,290,6924,0.13749277874061236
2193,33586,98,4957,1792,40433,0.12259787797096432
2194,3424,15,281,256,3976,0.07067404426559357
2195,4835,7,903,245,5990,0.15075125208681137
2196,1986,1,298,186,2471,0.12059894779441521
2197,5360,18,439,492,6309,0.06958313520367729
2198,989,3,130,42,1164,0.11168384879725086
2199,971,2,60,66,1099,0.0545950864422202
2200,9970,7,803,560,11340,0.07081128747795415
2201,4267,2,511,180,4960,0.1030241935483871
2202,3296,8,621,175,4100,0.15146341463414634
2203,2793,9,236,170,3208,0.07356608478802992
2204,2900,3,333,176,3412,0.09759671746776084
2205,1187,3,114,65,1369,0.08327246165084003
2206,83622,78,1724,7768,93192,0.018499442012189886
2207,2394,5,88,90,2577,0.03414823438106325
2208,2515,2,260,114,2891,0.08993427879626427
2209,1366,1,128,40,1535,0.08338762214983714
2210,10710,17,384,1074,12185,0.031514156750102586
2211,1623,0,105,87,1815,0.05785123966942149
2212,4288,7,332,343,4970,0.06680080482897384
2213,37971,68,2245,2337,42621,0.05267356467469088
2214,736,3,44,75,858,0.05128205128205128
2215,3180,6,385,158,3729,0.10324483775811209
2216,4653,3,571,175,5402,0.10570159200296186
2217,52230,101,3721,4150,60202,0.06180857778811335
2218,1748,6,185,131,2070,0.0893719806763285
2219,6013,10,569,283,6875,0.08276363636363636
2220,2393,7,173,96,2669,0.0648182840014987
2221,2888,8,391,127,3414,0.11452841241944933
2222,5616,4,232,345,6197,0.03743746974342424
2223,83027,166,6668,4428,94289,0.07071874768000509
2224,3573,5,269,210,4057,0.06630515158984471
2225,7125,13,143,399,7680,0.018619791666666666
2226,767,0,77,56,900,0.08555555555555555
2227,437,0,25,27,489,0.05112474437627812
2228,7967,2,294,402,8665,0.03392960184650894
2229,11237,29,604,765,12635,0.04780371982588049
2230,839,1,71,73,984,0.07215447154471545
2231,999,2,122,59,1182,0.10321489001692047
2232,3456,10,653,262,4381,0.14905272768774253
2233,3049,4,396,226,3675,0.10775510204081633
2234,3505,3,110,192,3810,0.028871391076115485
2235,16700,27,493,1369,18589,0.0265210608424337
2236,5551,2,523,309,6385,0.08191072826938137
2237,4260,11,225,308,4804,0.04683597002497918
2238,2475,7,447,71,3000,0.149
2239,11331,19,371,1141,12862,0.028844658684496968
2240,7804,2,466,630,8902,0.05234778701415412
2241,2135,6,309,112,2562,0.12060889929742388
2242,10695,35,2157,1200,14087,0.1531198977780933
2243,2208,4,188,268,2668,0.0704647676161919
2244,1793,8,67,102,1970,0.03401015228426396
2245,2896,3,179,143,3221,0.055572803477181
2246,65382,37,1599,4060,71078,0.022496412392020035
2247,733,2,71,28,834,0.08513189448441247
2248,1210,5,110,47,1372,0.08017492711370262
2249,2179,1,118,154,2452,0.04812398042414356
2250,954,2,49,55,1060,0.04622641509433962
2251,7182,8,120,545,7855,0.015276893698281349
2252,1306,3,104,97,1510,0.06887417218543046
2253,2354,3,80,72,2509,0.03188521323236349
2254,3838,10,323,168,4339,0.07444111546439272
2255,2134,13,451,84,2682,0.16815809097688292
2256,6645,9,570,413,7637,0.07463663742307189
2257,3821,5,587,374,4787,0.12262377271777732
2258,1897,2,213,105,2217,0.09607577807848444
2259,1239,4,209,30,1482,0.14102564102564102
2260,22000,7,389,599,22995,0.016916721026310068
2261,1898,2,134,72,2106,0.06362773029439696
2262,1386,1,85,15,1487,0.05716207128446537
2263,5431,1,187,510,6129,0.030510686898352096
2264,2375,5,196,91,2667,0.07349081364829396
2265,4784,14,377,482,5657,0.06664309704790525
2266,2856,4,195,119,3174,0.06143667296786389
2267,3740,14,384,219,4357,0.08813403718154694
2268,2393,3,268,190,2854,0.09390329362298529
2269,8173,10,302,837,9322,0.032396481441750696
2270,1488,1,281,82,1852,0.15172786177105832
2271,2866,3,203,210,3282,0.061852528945764776
2272,980,2,80,30,1092,0.07326007326007326
2273,37507,66,4445,2947,44965,0.09885466473924163
2274,4424,2,345,185,4956,0.06961259079903148
2275,2429,4,244,149,2826,0.08634111818825195
2276,2096,7,159,194,2456,0.06473941368078176
2277,9138,21,951,546,10656,0.0892454954954955
2278,18215,47,2641,1275,22178,0.11908197312652177
2279,15885,21,704,1493,18103,0.03888858200298293
2280,4248,7,549,213,5017,0.10942794498704406
2281,8669,6,921,429,10025,0.09187032418952619
2282,842,6,56,68,972,0.05761316872427984
2283,8317,10,861,728,9916,0.08682936668011294
2284,5599,16,348,326,6289,0.05533471140085864
2285,5318,6,828,186,6338,0.13064058062480277
2286,1238,2,119,66,1425,0.08350877192982456
2287,368,0,43,14,425,0.1011764705882353
2288,1242,5,107,116,1470,0.0727891156462585
2289,2689,7,169,310,3175,0.053228346456692915
2290,1590,7,312,78,1987,0.15702063412179165
2291,2578,8,241,168,2995,0.08046744574290485
2292,32850,29,1403,1331,35613,0.039395726279729315
2293,2818,1,249,244,3312,0.07518115942028986
2294,4283,11,418,208,4920,0.08495934959349594
2295,7514,12,408,366,8300,0.0491566265060241
2296,1729,4,99,104,1936,0.05113636363636364
2297,3584,6,541,177,4308,0.1255803156917363
2298,5837,7,378,383,6605,0.057229371688115066
2299,5246,21,145,321,5733,0.025292168149311005
2300,3786,12,515,312,4625,0.11135135135135135
2301,1702,2,310,97,2111,0.1468498342018001
2302,6755,17,801,325,7898,0.10141808052671562
2303,30971,52,903,1904,33830,0.026692284954182677
2304,2857,1,307,188,3353,0.09155979719654041
2305,1205,9,213,69,1496,0.142379679144385
2306,2989,0,259,233,3481,0.0744039069232979
2307,1729,6,148,147,2030,0.0729064039408867
2308,4249,4,225,584,5062,0.04444883445278546
2309,2203,10,117,174,2504,0.04672523961661342
2310,25253,15,193,811,26272,0.007346224116930572
2311,3535,12,264,202,4013,0.06578619486668327
2312,5369,15,152,342,5878,0.025859135760462743
2313,10489,22,1096,690,12297,0.08912742945433845
2314,3385,5,201,314,3905,0.05147247119078105
2315,5102,12,161,274,5549,0.029014236799423318
2316,1669,1,106,157,1933,0.05483704086911537
2317,1299,3,82,58,1442,0.056865464632454926
2318,38871,88,4112,2416,45487,0.09039945478928045
2319,1843,6,115,105,2069,0.055582406959884
2320,2717,1,476,123,3317,0.14350316551100392
2321,1767,2,142,74,1985,0.07153652392947103
2322,2480,3,489,114,3086,0.15845755022683086
2323,7689,8,1103,526,9326,0.11827149903495604
2324,2318,9,72,91,2490,0.02891566265060241
2325,2237,6,299,118,2660,0.11240601503759398
2326,2538,10,433,172,3153,0.13732952743418966
2327,1870,2,164,141,2177,0.07533302710151585
2328,6756,5,485,238,7484,0.06480491715660075
2329,1694,3,77,155,1929,0.039917055469155
2330,4279,8,186,389,4862,0.03825586178527355
2331,1332,0,163,64,1559,0.10455420141116101
2332,12361,16,1502,596,14475,0.1037651122625216
2333,20117,14,423,1602,22156,0.01909189384365409
2334,4335,11,1069,196,5611,0.1905186241311709
2335,1024,2,84,73,1183,0.07100591715976332
2336,104757,121,6039,4408,115325,0.05236505527856059
2337,7404,2,795,435,8636,0.09205650764242705
2338,6155,0,178,578,6911,0.025756041093908263
2339,1244,1,322,77,1644,0.19586374695863748
2340,956,0,50,61,1067,0.046860356138706656
2341,4548,6,815,174,5543,0.14703229298213963
2342,1991,6,188,121,2306,0.08152645273200347
2343,637,0,161,15,813,0.1980319803198032
2344,1804,6,216,110,2136,0.10112359550561797
2345,5956,17,583,542,7098,0.08213581290504367
2346,6554,13,640,673,7880,0.08121827411167512
2347,3930,1,610,228,4769,0.12790941497169217
2348,2821,7,306,119,3253,0.09406701506301875
2349,2349,1,206,114,2670,0.07715355805243446
2350,754,0,54,79,887,0.060879368658399095
2351,4886,5,1135,233,6259,0.18133887202428503
2352,8217,6,949,480,9652,0.09832159138002486
2353,2927,4,140,138,3209,0.04362729822374572
2354,1079,3,78,43,1203,0.06483790523690773
2355,5834,7,731,278,6850,0.10671532846715329
2356,654,0,164,39,857,0.19136522753792298
2357,1832,6,125,79,2042,0.06121449559255632
2358,18285,16,1138,876,20315,0.05601772089588974
2359,7918,8,240,495,8661,0.027710426047800486
2360,3386,12,617,217,4232,0.14579395085066163
2361,3324,10,580,716,4630,0.12526997840172785
2362,22664,38,1207,1630,25539,0.047261051724813034
2363,5508,8,367,463,6346,0.05783170501103057
2364,948,0,143,61,1152,0.12413194444444445
2365,11856,29,1757,504,14146,0.12420472218294924
2366,4413,5,455,290,5163,0.08812705791206663
2367,45218,98,2337,4386,52039,0.04490862622264071
2368,650,1,75,62,788,0.09517766497461928
2369,647,0,19,27,693,0.027417027417027416
2370,12936,15,2099,624,15674,0.13391603930075283
2371,101628,84,904,2884,105500,0.008568720379146919
2372,7168,15,128,356,7667,0.016694926307551844
2373,4330,10,717,146,5203,0.13780511243513358
2374,18636,16,2812,1274,22738,0.1236696279356144
2375,10554,12,542,374,11482,0.047204319804912034
2376,2432,1,312,267,3012,0.10358565737051793
2377,27032,100,1876,1447,30455,0.061599080610737156
2378,20100,19,392,916,21427,0.01829467494282914
2379,1861,0,157,87,2105,0.07458432304038004
2380,537,0,74,27,638,0.11598746081504702
2381,1622,3,131,108,1864,0.07027896995708155
2382,36278,71,1632,2139,40120,0.04067796610169491
2383,3364,5,260,173,3802,0.0683850604944766
2384,2514,1,122,189,2826,0.043170559094125975
2385,80096,194,11189,4660,96139,0.11638356962314982
2386,2688,2,96,85,2871,0.03343782654127482
2387,28528,22,1311,8831,38692,0.03388297322443916
2388,9962,19,724,525,11230,0.06447016918967052
2389,4687,11,528,301,5527,0.09553102949158676
2390,2611,6,338,176,3131,0.10795273075694667
2391,8092,6,1253,654,10005,0.12523738130934534
2392,1741,2,228,66,2037,0.11192930780559647
2393,2016,10,173,101,2300,0.07521739130434782
2394,2826,9,444,107,3386,0.13112817483756645
2395,4383,7,314,240,4944,0.06351132686084142
2396,5220,6,359,364,5949,0.06034627668515717
2397,25338,69,2032,1008,28447,0.07143108236369389
2398,2135,2,295,120,2552,0.11559561128526646
2399,3066,4,310,139,3519,0.08809320829781188
2400,7790,14,80,678,8562,0.00934361130576968
2401,2529,10,127,155,2821,0.04501949663239986
2402,9513,19,833,581,10946,0.0761008587611913
2403,64001,112,4461,1914,70488,0.06328736806264897
2404,19947,33,1825,1039,22844,0.07988968656977762
2405,1808,10,235,106,2159,0.10884668828161186
2406,325,0,37,18,380,0.09736842105263158
2407,11506,9,1959,673,14147,0.1384745882519262
2408,641,2,91,50,784,0.11607142857142858
2409,1846,7,236,86,2175,0.10850574712643678
2410,4496,10,213,828,5547,0.03839913466738778
2411,2966,7,354,157,3484,0.10160734787600459
2412,114500,91,1805,4399,120795,0.014942671468189908
2413,4630,14,435,168,5247,0.08290451686678102
2414,5234,8,341,360,5943,0.05737842840316339
2415,1413,0,286,91,1790,0.15977653631284916
2416,3860,3,110,315,4288,0.025652985074626867
2417,3584,5,391,173,4153,0.09414880809053697
2418,62714,104,5164,4000,71982,0.07174015726153761
2419,7347,16,385,452,8200,0.04695121951219512
2420,36914,38,2719,2179,41850,0.06497013142174432
2421,1194,0,168,72,1434,0.11715481171548117
2422,8476,6,597,886,9965,0.0599096838936277
2423,2289,3,90,157,2539,0.035447026388341865
2424,12510,38,871,650,14069,0.06190916198734807
2425,5539,2,566,451,6558,0.08630680085391888
2426,5624,3,149,275,6051,0.024624029086101472
2427,725,2,79,31,837,0.09438470728793309
2428,1742,5,90,113,1950,0.046153846153846156
2429,3129,4,572,169,3874,0.1476510067114094
2430,736,1,77,8,822,0.09367396593673966
2431,9364,23,203,446,10036,0.02022718214428059
2432,2775,3,360,268,3406,0.10569583088667057
2433,9496,14,511,1235,11256,0.04539800995024876
2434,1716,22,102,151,1991,0.051230537418382724
2435,10504,21,1807,848,13180,0.13710166919575115
2436,15825,17,934,820,17596,0.05308024551034326
2437,3979,2,393,189,4563,0.0861275476660092
2438,1431,3,213,143,1790,0.11899441340782123
2439,2878,4,247,105,3234,0.07637600494743352
2440,15226,10,710,1205,17151,0.04139700309019882
2441,8880,15,958,1045,10898,0.08790603780510185
2442,3711,6,204,159,4080,0.05
2443,3609,17,83,206,3915,0.02120051085568327
2444,3296,2,172,293,3763,0.04570821153335105
2445,6121,7,673,270,7071,0.09517748550417197
2446,2369,3,119,201,2692,0.04420505200594354
2447,17895,36,2024,752,20707,0.09774472400637466
2448,13603,44,1557,546,15750,0.09885714285714285
2449,23494,26,1142,1112,25774,0.04430821758361139
2450,9796,10,973,501,11280,0.08625886524822696
2451,2553,2,500,173,3228,0.15489467162329615
2452,2820,12,202,171,3205,0.06302652106084243
2453,5011,6,435,390,5842,0.07446080109551523
2454,18645,24,1156,1111,20936,0.05521589606419564
2455,4189,3,719,322,5233,0.13739728645136634
2456,6637,19,150,435,7241,0.020715370805137412
2457,4657,10,249,435,5351,0.04653335825079424
2458,1131,4,128,63,1326,0.09653092006033183
2459,38624,92,2664,2323,43703,0.06095691371301741
2460,9689,34,575,328,10626,0.05411255411255411
2461,1530,2,237,80,1849,0.12817739318550567
2462,3769,5,538,275,4587,0.11728798779158492
2463,2472,3,307,119,2901,0.10582557738710789
2464,3172,7,224,103,3506,0.0638904734740445
2465,13234,49,431,455,14169,0.030418519302703083
2466,3745,5,189,217,4156,0.045476419634263715
2467,455,0,68,31,554,0.12274368231046931
2468,116537,149,5245,4930,126861,0.041344463625542914
2469,5897,16,150,347,6410,0.0234009360374415
2470,592,1,113,35,741,0.1524966261808367
2471,4597,10,192,167,4966,0.038662907772855415
2472,9717,22,478,270,10487,0.04558024220463431
2473,5197,20,399,304,5920,0.06739864864864865
2474,3466,3,545,283,4297,0.12683267395857575
2475,3032,1,92,94,3219,0.02858030444237341
2476,3004,3,81,111,3199,0.025320412628946545
2477,4862,2,128,452,5444,0.02351212343864805
2478,1438,1,153,72,1664,0.09194711538461539
2479,7576,15,145,416,8152,0.01778704612365064
2480,620,0,49,30,699,0.07010014306151645
2481,3429,3,387,293,4112,0.0941147859922179
2482,31139,96,4282,3478,38995,0.10980894986536735
2483,3514,7,160,339,4020,0.03980099502487562
2484,18890,35,1113,1057,21095,0.05276131784783124
2485,3805,7,80,345,4237,0.018881283927307056
2486,2088,4,166,171,2429,0.0683408810209963
2487,627,1,64,43,735,0.08707482993197278
2488,2247,3,229,118,2597,0.08817866769349249
2489,4548,3,463,269,5283,0.08763959871285254
2490,1982,9,136,111,2238,0.06076854334226988
2491,3788,17,208,178,4191,0.049630159866380336
2492,4697,2,912,192,5803,0.15716008960882302
2493,524,1,122,25,672,0.18154761904761904
2494,1151,5,92,72,1320,0.0696969696969697
2495,2337,3,324,137,2801,0.11567297393787933
2496,4425,4,226,253,4908,0.04604726976365118
2497,3372,8,282,155,3817,0.07388001047943411
2498,8824,9,1750,394,10977,0.15942425070602168
2499,1148,2,255,79,1484,0.17183288409703504
2500,3794,7,332,240,4373,0.07592042076377772
2501,1408,8,110,56,1582,0.0695322376738306
2502,916,2,113,38,1069,0.10570626753975679
2503,7775,19,237,565,8596,0.027570963238715683
2504,1242,5,176,77,1500,0.11733333333333333
2505,6074,24,502,447,7047,0.07123598694479921
2506,26994,44,4298,2386,33722,0.12745388766977048
2507,1469,2,83,87,1641,0.050578915295551495
2508,6590,16,581,388,7575,0.0766996699669967
2509,3261,1,386,185,3833,0.10070440907905036
2510,18155,29,1523,1036,20743,0.07342235935014221
2511,18332,32,2363,1231,21958,0.10761453684306403
2512,12411,24,414,555,13404,0.03088630259623993
2513,1115,3,146,62,1326,0.11010558069381599
2514,1584,1,132,87,1804,0.07317073170731707
2515,3586,5,431,212,4234,0.10179499291450166
2516,2633,2,151,118,2904,0.05199724517906336
2517,3899,5,92,409,4405,0.020885357548240637
2518,8862,14,251,857,9984,0.02514022435897436
2519,1996,9,81,95,2181,0.037138927097661624
2520,3286,5,490,222,4003,0.12240819385460905
2521,1363,4,249,105,1721,0.14468332364904127
2522,1094,9,177,30,1310,0.13511450381679388
2523,1016,3,72,47,1138,0.0632688927943761
2524,1560,4,140,48,1752,0.07990867579908675
2525,1479,8,79,123,1689,0.046773238602723505
2526,9685,13,1741,667,12106,0.14381298529654718
2527,6631,14,273,418,7336,0.03721374045801527
2528,2324,2,132,138,2596,0.05084745762711865
2529,2953,3,472,175,3603,0.13100194282542327
2530,7544,26,610,424,8604,0.0708972570897257
2531,6864,14,415,298,7591,0.054670003952048477
2532,3377,10,342,93,3822,0.08948194662480377
2533,2349,3,494,151,2997,0.1648314981648315
2534,2327,9,266,107,2709,0.09819121447028424
2535,5233,13,386,302,5934,0.06504887091338052
2536,1365,1,132,149,1647,0.08014571948998178
2537,39593,123,6060,2318,48094,0.12600324364785628
2538,2148,11,235,192,2586,0.09087393658159319
2539,1660,4,104,137,1905,0.05459317585301837
2540,4690,14,356,254,5314,0.06699284907790741
2541,10761,20,767,786,12334,0.062185827793092265
2542,3633,2,238,408,4281,0.0555944872693296
2543,2337,6,154,205,2702,0.05699481865284974
2544,4000,3,83,244,4330,0.019168591224018476
2545,54472,101,2547,2611,59731,0.04264117459945422
2546,1292,3,89,114,1498,0.05941255006675567
2547,17296,39,1682,1117,20134,0.08354028012317473
2548,2891,2,376,140,3409,0.1102962745673218
2549,2565,3,57,271,2896,0.01968232044198895
2550,6625,7,518,569,7719,0.06710713823034072
2551,3827,7,476,200,4510,0.10554323725055433
2552,2229,1,229,111,2570,0.08910505836575876
2553,1270,1,78,64,1413,0.055201698513800426
2554,1439,4,136,50,1629,0.08348680171884591
2555,5824,10,257,587,6678,0.038484576220425275
2556,3478,12,236,189,3915,0.060280970625798215
2557,3331,7,135,234,3707,0.03641758834637173
2558,1242,2,75,62,1381,0.05430847212165098
2559,7031,10,633,428,8102,0.07812885707232782
2560,78589,104,3045,3147,84885,0.03587206220180244
2561,5183,6,189,165,5543,0.034097059354140355
2562,6688,13,1134,300,8135,0.13939766441303011
2563,4192,3,235,388,4818,0.04877542548775426
2564,12522,12,356,955,13845,0.025713253882267965
2565,36603,89,3210,1989,41891,0.07662743787448378
2566,6430,10,716,197,7353,0.09737522099823201
2567,2428,2,263,68,2761,0.09525534226729446
2568,1182,2,38,94,1316,0.028875379939209727
2569,20915,21,1945,905,23786,0.08177078954006559
2570,13676,14,2276,980,16946,0.13430898147055353
2571,2086,3,275,189,2553,0.10771641206423815
2572,3894,2,779,157,4832,0.16121688741721854
2573,8974,25,1345,609,10953,0.12279740710307678
2574,4075,6,253,599,4933,0.0512872491384553
2575,25005,47,4155,2114,31321,0.13265859966156893
2576,8018,4,1114,463,9599,0.11605375559954162
2577,4120,9,257,325,4711,0.05455317342390151
2578,1061,2,72,75,1210,0.05950413223140496
2579,20605,22,1213,1119,22959,0.05283331155538133
2580,17778,16,2252,1191,21237,0.10604134293920987
2581,970,0,156,65,1191,0.1309823677581864
2582,17423,38,606,1481,19548,0.03100061387354205
2583,7463,8,438,448,8357,0.052411152327390215
2584,18612,23,1067,1209,20911,0.05102577590741715
2585,700,1,60,25,786,0.07633587786259542
2586,11910,17,2255,415,14597,0.1544837980406933
2587,853,2,73,57,985,0.07411167512690356
2588,10097,25,885,345,11352,0.0779598308668076
2589,402,3,46,17,468,0.09829059829059829
2590,6875,15,549,452,7891,0.06957293118742872
2591,36146,45,5246,1744,43181,0.12148861767907182
2592,15999,49,1852,910,18810,0.09845826687931951
2593,6675,8,562,682,7927,0.07089693452756402
2594,41774,19,1116,2284,45193,0.024694089792667007
2595,867,1,131,43,1042,0.1257197696737044
2596,2838,4,266,187,3295,0.08072837632776934
2597,5616,18,191,579,6404,0.029825109306683324
2598,3466,8,196,239,3909,0.05014070094653364
2599,1493,7,115,89,1704,0.06748826291079812
2600,2732,4,432,131,3299,0.13094877235525917
2601,1987,4,156,96,2243,0.06954971020954079
2602,3848,3,130,245,4226,0.03076194983435873
2603,3962,2,212,439,4615,0.045937161430119174
2604,571,3,76,23,673,0.11292719167904904
2605,922,1,69,23,1015,0.06798029556650247
2606,23404,39,1145,1362,25950,0.0441233140655106
2607,4144,4,142,274,4564,0.031113058720420684
2608,6164,19,1220,299,7702,0.1584004154764996
2609,1624,4,198,123,1949,0.10159055926115956
2610,1594,3,441,38,2076,0.21242774566473988
2611,4243,5,839,242,5329,0.1574404203415275
2612,779,2,198,62,1041,0.19020172910662825
2613,1034,3,157,34,1228,0.1278501628664495
2614,1872,6,213,127,2218,0.09603246167718665
2615,1244,2,125,107,1478,0.08457374830852503
2616,2801,2,217,200,3220,0.06739130434782609
2617,56737,75,1459,5971,64242,0.022710999034899287
2618,3270,5,502,238,4015,0.12503113325031134
2619,2614,5,448,243,3310,0.13534743202416918
2620,4614,11,367,544,5536,0.06629335260115607
2621,3677,8,341,180,4206,0.08107465525439848
2622,2587,6,75,71,2739,0.027382256297918947
2623,3769,15,224,274,4282,0.052312003736571695
2624,3906,8,699,319,4932,0.14172749391727493
2625,965,1,43,58,1067,0.04029990627928772
2626,6720,6,336,420,7482,0.04490777866880513
2627,1183,2,106,77,1368,0.07748538011695906
2628,2504,10,82,207,2803,0.029254370317516945
2629,4381,5,674,277,5337,0.1262881768783961
2630,6360,3,451,295,7109,0.06344070896047264
2631,3096,12,307,188,3603,0.0852067721343325
2632,2710,3,302,191,3206,0.0941983780411728
2633,4121,8,505,306,4940,0.10222672064777327
2634,5513,12,303,118,5946,0.05095862764883956
2635,676,0,49,31,756,0.06481481481481481
2636,2849,8,383,152,3392,0.1129127358490566
2637,3773,5,985,176,4939,0.199433083620166
2638,2565,1,161,208,2935,0.05485519591141397
2639,64375,69,3484,2230,70158,0.049659340346076
2640,18100,35,1623,1073,20831,0.07791272622533724
2641,1989,2,227,97,2315,0.09805615550755939
2642,2446,4,152,143,2745,0.055373406193078324
2643,3479,3,152,205,3839,0.0395936441781714
2644,2679,7,197,148,3031,0.06499505113823821
2645,4093,2,291,312,4698,0.06194125159642401
2646,2789,1,1362,105,4257,0.31994362226920364
2647,4468,7,106,270,4851,0.021851164708307565
2648,555,2,61,24,642,0.09501557632398754
2649,1785,7,328,82,2202,0.14895549500454133
2650,1286,1,66,65,1418,0.0465444287729196
2651,8647,14,1953,548,11162,0.17496864361225586
2652,15324,16,664,602,16606,0.03998554739250873
2653,3791,4,411,150,4356,0.0943526170798898
2654,10983,7,187,597,11774,0.01588245286223883
2655,2881,0,335,157,3373,0.0993181144381856
2656,8004,17,2391,410,10822,0.22093882831269637
2657,6284,3,425,387,7099,0.05986758698408227
2658,1850,5,268,126,2249,0.11916407292129835
2659,720,4,72,26,822,0.08759124087591241
2660,1186,7,52,87,1332,0.03903903903903904
2661,1255,6,155,85,1501,0.10326449033977349
2662,7626,9,460,318,8413,0.054677285153928445
2663,2818,4,479,174,3475,0.13784172661870503
2664,60287,65,4988,1797,67137,0.07429584282884251
2665,7637,13,577,483,8710,0.06624569460390356
2666,2772,2,76,130,2980,0.025503355704697986
2667,10013,7,1939,432,12391,0.15648454523444436
2668,8455,8,1941,505,10909,0.17792648272068934
2669,42420,113,3054,2476,48063,0.06354160164783722
2670,3422,2,143,223,3790,0.037730870712401055
2671,2192,4,317,165,2678,0.11837191934279313
2672,2143,4,180,90,2417,0.07447248655357881
2673,2616,1,175,193,2985,0.05862646566164154
2674,10872,21,1165,576,12634,0.09221149279721387
2675,5636,4,250,338,6228,0.040141297366730895
2676,119502,318,4742,7905,132467,0.03579759487268527
2677,95033,152,5719,5543,106447,0.05372626753219912
2678,2410,3,172,187,2772,0.06204906204906205
2679,1635,2,180,89,1906,0.0944386149003148
2680,4722,7,248,570,5547,0.04470885163151253
2681,3807,9,468,221,4505,0.10388457269700332
2682,3930,1,226,226,4383,0.05156285649098791
2683,8076,21,117,210,8424,0.013888888888888888
2684,7883,10,544,290,8727,0.0623352813108743
2685,1865,0,51,120,2036,0.02504911591355599
2686,4084,2,109,258,4453,0.024477880080844373
2687,7262,6,374,609,8251,0.04532783904981214
2688,2051,5,127,98,2281,0.055677334502411226
2689,1168,4,159,56,1387,0.11463590483056957
2690,1781,10,89,123,2003,0.044433349975037444
2691,1285,2,144,66,1497,0.09619238476953908
2692,6544,12,540,375,7471,0.07227948065854638
2693,6897,8,398,430,7733,0.051467735678261996
2694,2115,2,251,165,2533,0.09909198578760363
2695,3743,7,263,282,4295,0.061233993015133874
2696,2872,2,497,243,3614,0.1375207526286663
2697,1195,3,168,69,1435,0.11707317073170732
2698,6300,17,341,256,6914,0.0493202198437952
2699,10037,9,1002,528,11576,0.08655839668279199
2700,13491,16,376,459,14342,0.026216706177660018
2701,4071,8,401,395,4875,0.08225641025641026
2702,6780,9,803,336,7928,0.10128657921291624
2703,3917,10,146,186,4259,0.03428034749941301
2704,16380,8,313,1393,18094,0.017298552006189898
2705,2971,4,234,151,3360,0.06964285714285715
2706,2405,6,119,133,2663,0.04468644386030792
2707,1775,3,91,88,1957,0.04649974450689831
2708,626,3,126,18,773,0.1630012936610608
2709,15585,28,1885,942,18440,0.1022234273318872
2710,2083,6,98,169,2356,0.04159592529711375
2711,15557,15,326,812,16710,0.019509275882704968
2712,2011,10,124,120,2265,0.05474613686534217
2713,7575,10,350,849,8784,0.039845173041894354
2714,921,3,85,35,1044,0.08141762452107279
2715,8001,26,916,408,9351,0.09795743770719709
2716,704,0,82,28,814,0.10073710073710074
2717,2113,1,275,138,2527,0.10882469331222794
2718,8916,17,1487,531,10951,0.1357866861473838
2719,1461,0,113,86,1660,0.06807228915662651
2720,20441,33,1054,1373,22901,0.046024191083358805
2721,58155,119,2212,2944,63430,0.03487308844395397
2722,5352,16,199,343,5910,0.033671742808798644
2723,5621,0,310,192,6123,0.050628776743426425
2724,7004,14,602,376,7996,0.07528764382191096
2725,3917,3,689,268,4877,0.14127537420545416
2726,1142,0,164,73,1379,0.11892675852066716
2727,2597,6,409,143,3155,0.12963549920760697
2728,1922,3,116,109,2150,0.053953488372093024
2729,2554,0,128,79,2761,0.04636001448750453
2730,6675,26,474,341,7516,0.06306546035125067
2731,3991,5,396,185,4577,0.08651955429320515
2732,737,1,38,60,836,0.045454545454545456
2733,3964,14,414,297,4689,0.08829174664107485
2734,2622,3,53,243,2921,0.01814447107155084
2735,969,2,104,51,1126,0.09236234458259325
2736,5471,6,109,296,5882,0.018531111866712004
2737,966,3,117,51,1137,0.10290237467018469
2738,816,1,117,33,967,0.12099276111685625
2739,4602,12,530,199,5343,0.09919520868425978
2740,1000,3,142,35,1180,0.12033898305084746
2741,5989,6,257,572,6824,0.037661195779601406
2742,9189,6,560,484,10239,0.054692841097763456
2743,16283,13,143,618,17057,0.008383654804479099
2744,3149,3,349,111,3612,0.09662236987818383
2745,13272,19,487,651,14429,0.033751472728532815
2746,12250,44,1712,898,14904,0.11486849168008588
2747,9818,40,726,561,11145,0.06514131897711979
2748,3940,10,420,235,4605,0.09120521172638436
2749,5523,14,374,398,6309,0.0592803930892376
2750,7831,8,267,396,8502,0.03140437544107269
2751,12384,22,319,984,13709,0.023269385075497848
2752,7295,10,878,509,8692,0.10101242521859181
2753,3564,9,219,657,4449,0.049224544841537425
2754,829,0,136,37,1002,0.13572854291417166
2755,2023,5,272,115,2415,0.11262939958592133
2756,3093,6,524,114,3737,0.14021942734814022
2757,5785,10,526,361,6682,0.07871894642322658
2758,4765,4,173,254,5196,0.03329484218629715
2759,3206,7,499,161,3873,0.12884069197004905
2760,1743,5,130,93,1971,0.06595636732623034
2761,3732,9,366,218,4325,0.0846242774566474
2762,6363,15,129,331,6838,0.018865165252997952
2763,4580,14,289,256,5139,0.0562366219108776
2764,3508,4,395,193,4100,0.09634146341463415
2765,1193,5,102,90,1390,0.07338129496402877
2766,3252,11,282,158,3703,0.07615446934917634
2767,7707,13,1603,531,9854,0.1626750558148975
2768,36959,43,1135,1957,40094,0.02830847508355365
2769,3555,10,263,288,4116,0.06389698736637513
2770,4423,22,137,348,4930,0.027789046653144016
2771,2055,4,235,86,2380,0.09873949579831932
2772,4800,1,893,253,5947,0.1501597444089457
2773,14348,22,228,1103,15701,0.014521368065728298
2774,3528,4,283,219,4034,0.07015369360436291
2775,5209,5,622,394,6230,0.0998394863563403
2776,3261,5,628,236,4130,0.15205811138014527
2777,11014,30,1852,502,13398,0.1382295865054486
2778,5734,8,766,479,6987,0.10963217403749821
2779,726,1,33,29,789,0.04182509505703422
2780,2451,5,208,123,2787,0.07463222102619303
2781,113041,108,1799,8943,123891,0.014520828793051957
2782,5387,4,410,308,6109,0.06711409395973154
2783,5227,2,280,271,5780,0.04844290657439446
2784,1244,1,140,58,1443,0.09702009702009702
2785,1491,3,69,91,1654,0.04171704957678356
2786,2379,5,362,93,2839,0.12750968650933428
2787,2163,7,245,86,2501,0.09796081567373051
2788,3120,7,208,135,3470,0.05994236311239193
2789,5789,4,364,436,6593,0.05521007128772941
2790,7959,23,614,450,9046,0.06787530400176874
2791,8245,29,716,477,9467,0.0756311397486004
2792,14841,20,3421,1670,19952,0.17146150761828388
2793,897,6,68,89,1060,0.06415094339622641
2794,3335,3,291,257,3886,0.07488419969119918
2795,7759,14,1071,353,9197,0.11645101663585952
2796,1961,5,74,125,2165,0.03418013856812933
2797,1890,4,183,111,2188,0.08363802559414991
2798,1679,1,279,103,2062,0.13530552861299708
2799,10924,17,361,868,12170,0.029663105998356615
2800,1956,7,247,146,2356,0.10483870967741936
2801,644,1,70,47,762,0.09186351706036745
2802,6547,6,890,424,7867,0.11313079954239227
2803,1564,2,212,100,1878,0.11288604898828541
2804,6285,9,322,402,7018,0.04588201766885153
2805,5272,10,92,248,5622,0.016364283173247954
2806,6659,8,403,791,7861,0.05126574227197558
2807,16465,7,850,1275,18597,0.04570629671452385
2808,1475,7,190,90,1762,0.10783200908059024
2809,3182,14,395,222,3813,0.1035929714135851
2810,8417,30,925,548,9920,0.09324596774193548
2811,6199,4,1220,395,7818,0.15605014070094653
2812,5518,6,414,424,6362,0.06507387613957875
2813,132131,207,3923,5961,142222,0.027583636849432578
2814,2901,6,313,118,3338,0.09376872378669862
2815,8339,12,388,254,8993,0.043144668075169576
2816,3078,2,315,394,3789,0.0831353919239905
2817,2492,4,170,123,2789,0.060953746862674796
2818,42493,73,3403,2402,48371,0.07035207045543818
2819,5355,6,751,390,6502,0.11550292217779144
2820,3562,0,125,165,3852,0.03245067497403946
2821,30654,80,3687,1316,35737,0.1031703836360075
2822,10703,52,696,541,11992,0.058038692461641096
2823,139683,167,7367,6628,153845,0.04788585914394358
2824,10168,18,856,328,11370,0.0752858399296394
2825,2480,9,201,165,2855,0.07040280210157618
2826,1422,1,111,79,1613,0.06881587104773713
2827,1686,1,64,134,1885,0.03395225464190981
2828,39606,31,951,3117,43705,0.021759524081912826
2829,13586,33,1426,965,16010,0.08906933166770768
2830,1498,1,128,66,1693,0.07560543414057885
2831,4120,8,361,276,4765,0.0757607555089192
2832,1297,2,136,38,1473,0.0923285811269518
2833,2352,3,155,151,2661,0.05824877865464111
2834,19333,6,302,1600,21241,0.014217786356574549
2835,7690,17,459,292,8458,0.054268148498462995
2836,2826,4,234,212,3276,0.07142857142857142
2837,2241,2,320,110,2673,0.11971567527123082
2838,16534,27,1973,1282,19816,0.09956600726685506
2839,3635,4,216,191,4046,0.05338606030647553
2840,1026,1,114,59,1200,0.095
2841,2356,1,59,180,2596,0.022727272727272728
2842,1242,3,97,48,1390,0.06978417266187051
2843,3737,3,290,200,4230,0.06855791962174941
2844,20265,46,1878,970,23159,0.08109158426529643
2845,4739,6,263,563,5571,0.04720875964817806
2846,17739,17,527,714,18997,0.02774122229825762
2847,2322,5,170,136,2633,0.06456513482719331
2848,1130,2,157,55,1344,0.11681547619047619
2849,23458,6,555,1039,25058,0.022148615212706523
2850,2351,2,339,120,2812,0.1205547652916074
2851,3646,5,163,393,4207,0.03874494889469931
2852,1444,5,100,147,1696,0.0589622641509434
2853,891,2,35,40,968,0.03615702479338843
2854,1776,3,111,140,2030,0.054679802955665026
2855,5645,10,291,356,6302,0.046175817200888605
2856,20945,53,1369,1429,23796,0.05753067742477727
2857,9521,13,1813,382,11729,0.15457413249211358
2858,360,1,31,11,403,0.07692307692307693
2859,4143,3,131,334,4611,0.028410323140316635
2860,2869,4,444,153,3470,0.12795389048991354
2861,17468,20,2826,841,21155,0.1335854407941385
2862,7468,3,74,267,7812,0.009472606246799796
2863,2286,1,150,215,2652,0.05656108597285068
2864,5530,12,135,310,5987,0.022548855854351093
2865,957,1,39,72,1069,0.03648269410664172
2866,2370,6,91,220,2687,0.03386676590993673
2867,2750,7,158,502,3417,0.046239391278899616
2868,1466,1,156,70,1693,0.09214412285883047
2869,10534,13,1236,642,12425,0.09947686116700201
2870,938,1,99,61,1099,0.09008189262966333
2871,8796,17,605,289,9707,0.062326156381992376
2872,14367,19,918,732,16036,0.05724619605886755
2873,4887,2,272,167,5328,0.05105105105105105
2874,21724,20,578,1572,23894,0.024190173265254876
2875,888,4,103,62,1057,0.09744560075685904
2876,21365,52,2744,1623,25784,0.10642258765125659
2877,7888,12,339,476,8715,0.038898450946643716
2878,8765,32,1356,269,10422,0.13010938399539435
2879,6628,15,667,258,7568,0.08813424947145877
2880,1145,1,224,74,1444,0.15512465373961218
2881,3022,1,86,203,3312,0.025966183574879228
2882,8436,6,216,758,9416,0.022939677145284623
2883,38921,28,879,2623,42451,0.020706226001743187
2884,13464,9,336,894,14703,0.022852479085900837
2885,2044,7,383,100,2534,0.1511444356748224
2886,3742,1,145,283,4171,0.0347638456005754
2887,2218,5,212,212,2647,0.08009066868152626
2888,1246,4,183,66,1499,0.12208138759172782
2889,1179,1,51,102,1333,0.03825956489122281
2890,1839,2,190,77,2108,0.09013282732447818
2891,11470,15,1027,305,12817,0.08012795505968635
2892,3786,11,114,163,4074,0.027982326951399118
2893,4042,2,411,233,4688,0.08767064846416382
2894,16382,20,522,1325,18249,0.028604307085319743
2895,11713,6,334,871,12924,0.025843392138656763
2896,3803,6,429,272,4510,0.0951219512195122
2897,2847,1,547,177,3572,0.15313549832026876
2898,20839,26,663,1590,23118,0.028678951466389827
2899,2001,3,69,83,2156,0.03200371057513915
2900,20753,33,866,2189,23841,0.03632397969883814
2901,1662,5,147,169,1983,0.07413010590015129
2902,1891,2,236,104,2233,0.10568741603224362
2903,7166,7,434,552,8159,0.053192793234465005
2904,1382,7,178,91,1658,0.10735826296743065
2905,12805,13,784,793,14395,0.0544633553317124
2906,2558,7,205,299,3069,0.06679700228087325
2907,2443,5,61,265,2774,0.02198990627253064
2908,2255,10,120,143,2528,0.04746835443037975
2909,3256,5,179,249,3689,0.04852263486039577
2910,7415,13,191,630,8249,0.023154321735967997
2911,1229,1,160,90,1480,0.10810810810810811
2912,15673,34,1279,1312,18298,0.06989834954639851
2913,11335,24,1130,511,13000,0.08692307692307692
2914,3571,6,639,165,4381,0.14585711024880163
2915,14870,15,1837,871,17593,0.1044165293014267
2916,4528,9,461,342,5340,0.08632958801498128
2917,2314,5,112,396,2827,0.039617969579059074
2918,1185,1,66,43,1295,0.050965250965250966
2919,2036,3,122,121,2282,0.05346187554776512
2920,1156,3,190,120,1469,0.12933968686181074
2921,1449,3,140,91,1683,0.08318478906714201
2922,816,4,81,39,940,0.08617021276595745
2923,4604,5,347,224,5180,0.06698841698841698
2924,2852,3,229,156,3240,0.07067901234567901
2925,26023,24,528,2071,28646,0.018431892759896668
2926,5427,12,413,267,6119,0.06749468867462004
2927,4378,6,564,356,5304,0.10633484162895927
2928,84335,147,6319,3626,94427,0.06691941923390556
2929,9831,25,772,804,11432,0.0675297410776767
2930,2446,8,316,171,2941,0.1074464467868072
2931,655,7,68,37,767,0.08865710560625815
2932,3456,9,111,188,3764,0.02948990435706695
2933,5476,3,699,690,6868,0.10177635410599883
2934,12322,23,1546,679,14570,0.10610844200411805
2935,9981,52,1206,375,11614,0.10384019287067332
2936,7451,30,1459,375,9315,0.15662909286097693
2937,5343,7,112,488,5950,0.018823529411764704
2938,5008,9,463,211,5691,0.0813565278509928
2939,1827,2,135,116,2080,0.06490384615384616
2940,3018,1,67,123,3209,0.020878778435649736
2941,3777,8,320,225,4330,0.07390300230946882
2942,13951,29,1504,948,16432,0.09152872444011685
2943,3283,1,95,89,3468,0.027393310265282585
2944,2556,7,433,149,3145,0.13767885532591415
2945,1772,7,238,96,2113,0.1126360624704212
2946,5272,10,446,414,6142,0.07261478345815696
2947,1832,1,101,132,2066,0.04888673765730881
2948,2216,3,275,91,2585,0.10638297872340426
2949,8652,10,636,376,9674,0.0657432292743436
2950,3416,4,183,265,3868,0.04731127197518097
2951,3933,3,340,154,4430,0.07674943566591422
2952,2825,5,417,250,3497,0.11924506720045754
2953,4419,14,939,206,5578,0.16833990677662244
2954,42649,75,6367,2870,51961,0.12253420834856912
2955,1989,2,134,226,2351,0.056997022543598466
2956,46450,60,2622,1822,50954,0.051458177964438516
2957,1784,0,259,68,2111,0.12269066792989104
2958,24274,39,1048,1919,27280,0.03841642228739003
2959,26623,44,6982,1008,34657,0.2014600225062758
2960,11316,13,489,664,12482,0.039176414036212144
2961,3794,12,315,282,4403,0.07154213036565978
2962,826,0,80,35,941,0.08501594048884166
2963,70237,165,1892,3563,75857,0.02494166655681084
2964,11294,12,162,868,12336,0.013132295719844358
2965,5131,9,293,381,5814,0.05039559683522532
2966,2569,4,83,95,2751,0.030170846964740095
2967,5489,8,149,134,5780,0.025778546712802768
2968,8017,12,394,586,9009,0.043734043734043736
2969,1108,1,140,123,1372,0.10204081632653061
2970,4673,1,164,358,5196,0.03156274056966898
2971,2188,4,177,117,2486,0.07119871279163315
2972,2585,2,152,95,2834,0.053634438955539876
2973,1666,1,215,122,2004,0.10728542914171657
2974,2911,10,198,147,3266,0.06062461726883037
2975,12409,24,1622,1022,15077,0.10758108376998077
2976,2932,2,384,168,3486,0.11015490533562823
2977,1663,7,273,56,1999,0.13656828414207103
2978,2901,4,134,191,3230,0.04148606811145511
2979,116,0,14,13,143,0.0979020979020979
2980,4018,2,586,304,4910,0.11934826883910386
2981,22385,66,1644,1970,26065,0.06307308651448303
2982,5695,8,1621,277,7601,0.21326141297197737
2983,7838,10,198,545,8591,0.023047375160051217
2984,2456,5,325,96,2882,0.11276891047883414
2985,612,0,185,51,848,0.21816037735849056
2986,3265,5,486,126,3882,0.125193199381762
2987,14675,19,1006,845,16545,0.06080386823813841
2988,1341,3,263,73,1680,0.15654761904761905
2989,1399,5,207,114,1725,0.12
2990,3974,3,123,213,4313,0.028518432645490376
2991,6382,8,1086,310,7786,0.13948111995890058
2992,2055,5,296,76,2432,0.12171052631578948
2993,37023,37,922,2311,40293,0.022882386518750155
2994,5467,4,407,624,6502,0.06259612426945556
2995,3245,1,538,149,3933,0.136791253496059
2996,1367,0,52,84,1503,0.034597471723220224
2997,3425,9,146,161,3741,0.039026998128842555
2998,2245,8,246,145,2644,0.09304084720121028
2999,4878,8,197,255,5338,0.03690520794304983
3000,3794,11,143,293,4241,0.03371846262673898
3001,16514,8,823,819,18164,0.04530940321515085
3002,3092,2,535,113,3742,0.14297167290219134
3003,15772,18,186,897,16873,0.011023528714514313
3004,18450,7,598,1212,20267,0.029506093649775498
3005,4414,9,232,281,4936,0.04700162074554295
3006,2726,2,257,142,3127,0.08218740006395907
3007,1185,3,55,75,1318,0.0417298937784522
3008,10861,10,347,630,11848,0.029287643484132344
3009,2722,9,172,161,3064,0.05613577023498695
3010,1577,6,75,85,1743,0.043029259896729774
3011,2556,5,75,309,2945,0.025466893039049237
3012,6278,6,119,466,6869,0.017324210219828214
3013,5597,14,240,370,6221,0.03857900659058029
3014,2348,7,202,148,2705,0.07467652495378928
3015,4842,3,839,355,6039,0.13893028647127006
3016,28386,19,2012,1363,31780,0.0633102580239144
3017,68664,128,1046,6121,75959,0.01377058676391211
3018,2446,8,469,214,3137,0.14950589735416003
3019,5870,19,271,637,6797,0.03987053111666912
3020,2643,1,77,263,2984,0.025804289544235925
3021,9407,11,290,590,10298,0.028160807923868714
3022,23424,109,2282,1051,26866,0.08494007295466388
3023,2509,2,165,166,2842,0.058057705840957076
3024,4483,7,359,150,4999,0.07181436287257452
3025,596,1,55,40,692,0.07947976878612717
3026,5974,3,146,358,6481,0.0225273877488042
3027,8449,15,484,523,9471,0.05110336817653891
3028,17356,22,897,886,19161,0.046813840613746674
3029,3868,7,252,432,4559,0.05527527966659355
3030,1713,1,40,102,1856,0.021551724137931036
3031,2495,5,310,173,2983,0.1039222259470332
3032,7647,16,1189,397,9249,0.12855443831765595
3033,27525,48,755,2528,30856,0.024468498833290123
3034,820,0,182,42,1044,0.1743295019157088
3035,15691,7,856,1596,18150,0.04716253443526171
3036,756,1,43,47,847,0.05076741440377804
3037,2542,0,143,109,2794,0.051181102362204724
3038,8618,4,156,519,9297,0.016779606324620847
3039,2910,5,68,161,3144,0.021628498727735368
3040,3160,9,228,167,3564,0.06397306397306397
3041,3302,5,242,174,3723,0.06500134300295461
3042,11840,15,1030,481,13366,0.07706120005985335
3043,4456,7,140,393,4996,0.02802241793434748
3044,5054,4,956,238,6252,0.1529110684580934
3045,11915,44,1909,395,14263,0.13384281006800813
3046,6198,18,539,337,7092,0.07600112803158489
3047,1283,2,102,75,1462,0.06976744186046512
3048,4373,11,351,271,5006,0.07011586096683979
3049,9361,8,719,802,10890,0.0660238751147842
3050,4976,1,645,145,5767,0.11184324605514132
3051,1226,1,127,55,1409,0.09013484740951029
3052,1153,0,29,94,1276,0.022727272727272728
3053,2803,2,122,162,3089,0.03949498219488508
3054,5298,6,289,249,5842,0.04946935980828483
3055,3254,7,775,140,4176,0.18558429118773948
3056,1975,7,296,117,2395,0.12359081419624217
3057,15524,32,716,1590,17862,0.040085096853655806
3058,9279,15,421,421,10136,0.04153512233622731
3059,2596,7,288,120,3011,0.09564928595151112
3060,2361,8,134,147,2650,0.050566037735849056
3061,3598,6,505,232,4341,0.11633264224832988
3062,4849,6,538,370,5763,0.09335415582162068
3063,42531,25,663,4115,47334,0.01400684497401445
3064,15913,17,1591,580,18101,0.08789569637036627
3065,3408,0,558,140,4106,0.1358986848514369
3066,2223,6,57,160,2446,0.02330335241210139
3067,8226,18,521,734,9499,0.05484787872407622
3068,1112,3,148,38,1301,0.1137586471944658
3069,1856,3,218,63,2140,0.10186915887850467
3070,4240,7,230,307,4784,0.04807692307692308
3071,2675,1,316,187,3179,0.0994023277760302
3072,2777,4,119,241,3141,0.037886023559375995
3073,13768,20,6144,760,20692,0.29692634834718734
3074,1687,5,157,59,1908,0.08228511530398323
3075,3422,8,340,193,3963,0.08579359071410547
3076,1427,1,197,90,1715,0.11486880466472303
3077,397,0,17,29,443,0.03837471783295711
3078,20232,66,3533,825,24656,0.1432916937053861
3079,2630,2,28,79,2739,0.01022270901788974
3080,9165,46,1155,537,10903,0.10593414656516555
3081,973,1,164,72,1210,0.13553719008264462
3082,3702,8,224,212,4146,0.054027978774722624
3083,2587,9,119,109,2824,0.042138810198300285
3084,1360,4,41,81,1486,0.02759084791386272
3085,18219,38,1353,963,20573,0.06576580955621446
3086,1206,2,127,73,1408,0.09019886363636363
3087,6943,22,696,294,7955,0.0874921433060968
3088,2608,4,421,224,3257,0.12926005526558182
3089,25048,28,1769,898,27743,0.06376383231806221
3090,4726,5,136,442,5309,0.025616877001318514
3091,5887,6,806,460,7159,0.1125855566419891
3092,10538,14,586,566,11704,0.050068352699931644
3093,911,1,77,38,1027,0.07497565725413827
3094,12453,29,420,793,13695,0.03066812705366922
3095,2785,8,300,204,3297,0.09099181073703366
3096,41659,51,2822,3696,48228,0.05851372646595339
3097,1031,1,182,68,1282,0.1419656786271451
3098,20919,37,588,1360,22904,0.02567237163814181
3099,9060,6,537,502,10105,0.05314200890648194
3100,2158,9,172,118,2457,0.07000407000407001
3101,1058,0,58,75,1191,0.04869857262804366
3102,13795,23,371,727,14916,0.024872620005363368
3103,10595,34,1021,439,12089,0.08445694432955579
3104,8518,11,293,527,9349,0.03134025029414911
3105,17981,17,1594,1045,20637,0.07723990890148762
3106,15748,12,367,1348,17475,0.02100143061516452
3107,6909,32,571,430,7942,0.0718962477965248
3108,3370,3,323,193,3889,0.08305476986371818
3109,893,3,145,57,1098,0.1320582877959927
3110,3314,0,341,259,3914,0.08712314767501278
3111,8997,9,687,412,10105,0.06798614547253835
3112,3185,7,635,148,3975,0.15974842767295597
3113,8405,6,317,326,9054,0.03501214932626463
3114,7619,20,277,440,8356,0.03314983245572044
3115,2764,3,289,106,3162,0.0913978494623656
3116,1686,3,147,86,1922,0.0764828303850156
3117,32283,28,731,2891,35933,0.020343416914813683
3118,669,1,60,60,790,0.0759493670886076
3119,3768,1,337,270,4376,0.0770109689213894
3120,5604,11,452,377,6444,0.07014276846679081
3121,38585,36,1659,2086,42366,0.03915875938252372
3122,4401,14,485,265,5165,0.09390125847047434
3123,3953,6,181,267,4407,0.04107102337190833
3124,2089,8,76,68,2241,0.03391343150379295
3125,15564,32,197,512,16305,0.012082183379331493
3126,3916,9,461,229,4615,0.09989165763813651
3127,1749,2,327,74,2152,0.15195167286245354
3128,47395,80,2876,2464,52815,0.05445422701883935
3129,1938,3,241,111,2293,0.10510248582642825
3130,17285,12,332,694,18323,0.01811930360748786
3131,4642,1,122,255,5020,0.024302788844621514
3132,1794,6,252,71,2123,0.11869995289684408
3133,1857,3,91,126,2077,0.043813192103996146
3134,1888,7,401,168,2464,0.1627435064935065
3135,4189,4,606,381,5180,0.11698841698841698
3136,7058,19,321,453,7851,0.04088651127244937
3137,9484,18,545,337,10384,0.052484591679506934
3138,5149,10,234,491,5884,0.03976886471787899
3139,53187,127,9173,2146,64633,0.1419244039422586
3140,9638,31,1103,682,11454,0.0962982364239567
3141,6441,3,483,529,7456,0.06478004291845493
3142,2178,14,80,188,2460,0.032520325203252036
3143,3779,4,363,170,4316,0.08410565338276181
3144,34425,65,2699,3766,40955,0.06590159931632279
3145,4310,2,86,257,4655,0.018474758324382383
3146,3522,4,159,236,3921,0.04055087987758225
3147,1375,5,113,93,1586,0.0712484237074401
3148,16484,25,691,805,18005,0.03837822826992502
3149,5714,6,479,442,6641,0.07212769161270893
3150,1659,2,196,45,1902,0.10304942166140904
3151,1019,0,248,66,1333,0.18604651162790697
3152,31240,100,2920,1396,35656,0.08189365043751402
3153,1461,3,112,146,1722,0.06504065040650407
3154,10579,12,982,738,12311,0.07976606287060352
3155,21003,22,2454,1674,25153,0.09756291496044209
3156,1687,5,178,89,1959,0.09086268504338949
3157,2144,3,108,127,2382,0.04534005037783375
3158,2338,8,129,150,2625,0.04914285714285714
3159,13732,35,2064,690,16521,0.1249319048483748
3160,13612,15,528,924,15079,0.03501558458783739
3161,21970,14,537,937,23458,0.02289197715065223
3162,2348,5,85,186,2624,0.03239329268292683
3163,16716,42,4725,741,22224,0.21260799136069114
3164,5602,4,741,455,6802,0.10893854748603352
3165,3173,5,282,270,3730,0.07560321715817694
3166,7807,12,195,641,8655,0.022530329289428077
3167,6307,8,300,557,7172,0.04182933630786392
3168,9048,13,267,275,9603,0.027803811308965948
3169,1257,3,177,70,1507,0.11745189117451892
3170,11351,10,1121,846,13328,0.08410864345738295
3171,1524,1,254,62,1841,0.13796849538294406
3172,5277,7,651,248,6183,0.10528869480834546
3173,10175,34,3274,410,13893,0.23565824515943282
3174,4089,8,73,297,4467,0.016342064025072756
3175,6080,4,1234,355,7673,0.16082366740518703
3176,4159,2,218,213,4592,0.047473867595818814
3177,24043,14,3148,1248,28453,0.11063859698450075
3178,5774,4,470,390,6638,0.07080445917445014
3179,4747,2,338,265,5352,0.06315396113602392
3180,5064,3,202,293,5562,0.03631787126932758
3181,7071,13,468,614,8166,0.05731080088170463
3182,440,1,76,25,542,0.14022140221402213
3183,112992,204,3660,4188,121044,0.0302369386338852
3184,1898,3,100,81,2082,0.04803073967339097
3185,22967,17,778,1327,25089,0.03100960580334011
3186,1066,2,92,65,1225,0.07510204081632653
3187,2114,8,113,112,2347,0.048146570089475926
3188,3788,2,708,274,4772,0.14836546521374686
3189,37673,74,945,2429,41121,0.02298095863427446
3190,381,0,148,14,543,0.27255985267034993
3191,21449,39,3108,1630,26226,0.11850835049187829
3192,5120,10,338,266,5734,0.058946634112312525
3193,2421,5,75,218,2719,0.027583670467083488
3194,3151,1,134,249,3535,0.03790664780763791
3195,2352,2,530,142,3026,0.1751487111698612
3196,39714,29,1940,1262,42945,0.045174059843986494
3197,801,1,65,29,896,0.07254464285714286
3198,2278,2,173,147,2600,0.06653846153846153
3199,1622,0,92,79,1793,0.051310652537646405
3200,35559,45,1366,2464,39434,0.03464015823908302
3201,3307,4,157,186,3654,0.042966611932129174
3202,2285,5,203,148,2641,0.07686482393032942
3203,34081,2,27,411,34521,0.0007821326149300426
3204,7832,5,214,539,8590,0.024912689173457507
3205,19506,42,2022,4661,26231,0.0770843658266936
3206,2213,5,390,239,2847,0.136986301369863
3207,1373,6,268,66,1713,0.15645067133683596
3208,2025,6,419,93,2543,0.16476602438065277
3209,6071,4,797,434,7306,0.10908842047632084
3210,2647,6,115,238,3006,0.03825681969394544
3211,1202,1,136,77,1416,0.096045197740113
3212,11223,18,620,909,12770,0.0485512920908379
3213,128271,64,1353,8984,138672,0.009756836275527864
3214,19605,39,1878,908,22430,0.08372715113687026
3215,14215,37,1014,729,15995,0.0633948108783995
3216,11671,9,417,527,12624,0.03303231939163498
3217,1199,4,159,63,1425,0.11157894736842106
3218,15734,18,1057,973,17782,0.059442132493532786
3219,6864,11,1382,392,8649,0.15978725864261764
3220,1293,2,135,55,1485,0.09090909090909091
3221,187,0,19,26,232,0.08189655172413793
3222,1160,0,82,100,1342,0.06110283159463487
3223,3488,11,210,135,3844,0.05463059313215401
3224,8773,14,810,370,9967,0.08126818501053476
3225,5560,17,404,265,6246,0.06468139609349983
3226,10486,25,567,584,11662,0.048619447779111646
3227,1515,1,258,87,1861,0.138635142396561
3228,1897,7,230,71,2205,0.10430839002267574
3229,864,2,19,40,925,0.02054054054054054
3230,13674,54,2232,805,16765,0.1331345064121682
3231,13951,6,261,866,15084,0.017303102625298328
3232,2220,2,105,134,2461,0.04266558309630231
3233,13064,17,849,553,14483,0.058620451563902505
3234,10522,20,629,748,11919,0.05277288363117711
3235,10506,15,2041,847,13409,0.1522112014318741
3236,18342,50,1262,2204,21858,0.05773629792295727
3237,1556,6,94,108,1764,0.05328798185941043
3238,1080,9,61,45,1195,0.05104602510460251
3239,2919,2,320,187,3428,0.09334889148191365
3240,2381,2,215,98,2696,0.07974777448071217
3241,1630,2,240,70,1942,0.12358393408856849
3242,8886,16,574,676,10152,0.056540583136327816
3243,5937,9,584,332,6862,0.0851063829787234
3244,1626,2,298,88,2014,0.14796425024826215
3245,698,5,68,42,813,0.08364083640836409
3246,5756,7,141,456,6360,0.022169811320754716
3247,1702,2,220,141,2065,0.10653753026634383
3248,4943,10,133,328,5414,0.024565940155153305
3249,4067,10,463,286,4826,0.09593866556154165
3250,7029,4,393,299,7725,0.05087378640776699
3251,5466,12,555,430,6463,0.08587343339006653
3252,2477,3,380,98,2958,0.12846517917511832
3253,2143,1,301,139,2584,0.11648606811145511
3254,1334,3,164,84,1585,0.10347003154574133
3255,18419,46,462,1004,19931,0.023179970899603632
3256,2410,0,240,70,2720,0.08823529411764706
3257,700,2,58,35,795,0.0729559748427673
3258,6206,3,234,178,6621,0.035342093339374714
3259,2795,15,293,137,3240,0.0904320987654321
3260,1174,2,64,49,1289,0.04965089216446858
3261,3548,8,125,220,3901,0.03204306588054345
3262,1818,46,75,226,2165,0.03464203233256351
3263,4577,20,499,155,5251,0.095029518187012
3264,1532,2,63,37,1634,0.038555691554467565
3265,3056,3,164,204,3427,0.047855266997373795
3266,7223,21,1060,388,8692,0.12195121951219512
3267,1395,2,46,59,1502,0.03062583222370173
3268,2739,2,299,97,3137,0.0953139942620338
3269,799,1,186,57,1043,0.17833173537871524
3270,8753,24,652,497,9926,0.06568607696957485
3271,5920,7,398,551,6876,0.0578824898196626
3272,1355,6,67,209,1637,0.04092852779474649
3273,1244,10,105,45,1404,0.07478632478632478
3274,2399,2,666,107,3174,0.20982986767485823
3275,5443,10,257,561,6271,0.040982299473768136
3276,2543,0,450,125,3118,0.14432328415651058
3277,4502,13,385,249,5149,0.07477180034958245
3278,1534,3,247,90,1874,0.13180362860192102
3279,16665,17,2019,938,19639,0.10280564183512399
3280,4493,7,172,388,5060,0.03399209486166008
3281,1170,3,74,57,1304,0.05674846625766871
3282,5011,0,1089,190,6290,0.17313195548489665
3283,5671,12,380,238,6301,0.06030788763688304
3284,6653,33,912,358,7956,0.11463046757164404
3285,664,0,84,43,791,0.10619469026548672
3286,3301,3,453,235,3992,0.11347695390781563
3287,1370,10,71,92,1543,0.04601425793907971
3288,8745,15,1554,945,11259,0.13802291500133226
3289,4349,11,403,231,4994,0.08069683620344413
3290,2850,6,781,222,3859,0.20238403731536667
3291,4573,21,804,313,5711,0.14078094904570126
3292,678,0,59,31,768,0.07682291666666667
3293,2354,3,54,231,2642,0.02043906131718395
3294,12429,8,144,285,12866,0.011192289755945904
3295,73980,68,1472,3448,78968,0.018640461959274643
3296,28688,32,333,1995,31048,0.010725328523576399
3297,7713,7,873,732,9325,0.09361930294906166
3298,6446,3,1094,572,8115,0.1348120764017252
3299,3279,4,340,143,3766,0.09028146574614976
3300,3930,5,338,299,4572,0.07392825896762904
3301,1214,3,228,43,1488,0.1532258064516129
3302,6284,6,171,200,6661,0.025671821047890706
3303,2448,5,194,156,2803,0.06921155904388156
3304,8127,12,481,517,9137,0.05264309948560797
3305,2538,6,418,121,3083,0.13558222510541681
3306,1776,3,84,137,2000,0.042
3307,916,3,143,39,1101,0.1298819255222525
3308,9739,9,690,747,11185,0.06168976307554761
3309,667,1,44,43,755,0.05827814569536424
3310,2395,3,421,120,2939,0.14324600204151072
3311,4504,8,122,309,4943,0.024681367590532067
3312,1143,3,138,76,1360,0.10147058823529412
3313,2706,5,112,160,2983,0.03754609453570231
3314,3201,11,151,100,3463,0.04360381172393878
3315,79035,40,968,5208,85251,0.011354705516650831
3316,1671,0,352,86,2109,0.16690374585111428
3317,4521,3,338,155,5017,0.06737093880805262
3318,1699,3,106,123,1931,0.05489383738995339
3319,21737,34,2700,1488,25959,0.10401016988327748
3320,5903,9,1996,330,8238,0.2422918184025249
3321,1620,4,104,122,1850,0.05621621621621622
3322,4033,6,585,305,4929,0.11868533171028606
3323,16637,42,2209,627,19515,0.1131949782218806
3324,1724,2,81,95,1902,0.04258675078864353
3325,2696,1,212,121,3030,0.06996699669966996
3326,51110,77,4043,2308,57538,0.070266606416629
3327,3478,3,123,225,3829,0.03212326978323322
3328,3823,2,336,179,4340,0.07741935483870968
3329,2674,5,406,183,3268,0.12423500611995104
3330,1920,3,258,89,2270,0.11365638766519824
3331,1564,0,168,44,1776,0.0945945945945946
3332,5513,7,576,413,6509,0.0884928560454755
3333,918,2,75,30,1025,0.07317073170731707
3334,3538,1,644,181,4364,0.14757103574702107
3335,2849,4,368,242,3463,0.10626624314178458
3336,2209,2,133,138,2482,0.053585817888799354
3337,1576,4,84,117,1781,0.047164514317798986
3338,6114,9,121,572,6816,0.017752347417840375
3339,2470,3,239,134,2846,0.08397751229796205
3340,2196,4,99,130,2429,0.04075751337999177
3341,3277,13,179,267,3736,0.04791220556745182
3342,723,0,29,39,791,0.03666245259165613
3343,1345,2,125,64,1536,0.08138020833333333
3344,2588,6,356,191,3141,0.11333970073225087
3345,4703,16,681,415,5815,0.11711092003439381
3346,2223,1,187,77,2488,0.07516077170418006
3347,4357,4,417,215,4993,0.08351692369317044
3348,6118,0,122,694,6934,0.017594462070954716
3349,25538,33,640,1157,27368,0.0233849751534639
3350,25620,64,2851,1886,30421,0.09371815522172183
3351,2239,7,180,193,2619,0.06872852233676977
3352,2556,1,278,139,2974,0.09347679892400806
3353,11910,11,1137,475,13533,0.08401684770560851
3354,38089,17,613,1136,39855,0.015380755237736797
3355,7681,9,424,604,8718,0.04863500802936453
3356,4656,2,366,178,5202,0.07035755478662054
3357,6266,7,294,591,7158,0.04107292539815591
3358,1644,1,121,96,1862,0.06498388829215897
3359,668,3,26,16,713,0.0364656381486676
3360,1767,3,432,72,2274,0.18997361477572558
3361,7213,11,233,217,7674,0.030362262183997915
3362,2421,1,258,135,2815,0.09165186500888099
3363,2770,10,502,238,3520,0.14261363636363636
3364,1316,5,205,56,1582,0.12958280657395702
3365,6222,16,996,380,7614,0.13081166272655634
3366,7727,20,285,757,8789,0.03242689725793606
3367,933,3,132,49,1117,0.11817367949865712
3368,23934,31,1824,1711,27500,0.06632727272727272
3369,2635,4,66,222,2927,0.022548684660061498
3370,406,3,82,19,510,0.1607843137254902
3371,10907,8,848,661,12424,0.06825499034127495
3372,885,2,215,70,1172,0.18344709897610922
3373,3602,3,239,207,4051,0.05899777832633918
3374,4750,7,112,251,5120,0.021875
3375,1810,7,126,113,2056,0.061284046692607
3376,51641,9,747,2178,54575,0.01368758589097572
3377,14226,33,344,1023,15626,0.022014591066171766
3378,2021,3,219,50,2293,0.09550806803314435
3379,1122,6,81,68,1277,0.06342991386061081
3380,3099,10,302,148,3559,0.0848552964315819
3381,7855,16,657,793,9321,0.07048599935629224
3382,2218,1,98,194,2511,0.039028275587415374
3383,2323,6,348,138,2815,0.1236234458259325
3384,1451,1,221,74,1747,0.12650257584430452
3385,931,4,55,107,1097,0.05013673655423884
3386,2123,3,157,84,2367,0.06632868610054922
3387,1067,1,62,86,1216,0.05098684210526316
3388,7083,9,331,935,8358,0.03960277578368031
3389,5729,10,535,417,6691,0.07995815274248991
3390,3243,6,444,88,3781,0.11742925152076171
3391,4441,6,117,339,4903,0.023862941056496022
3392,9297,21,688,982,10988,0.06261376046596287
3393,2532,2,391,205,3130,0.12492012779552715
3394,2955,4,221,124,3304,0.06688861985472155
3395,34261,62,2107,2124,38554,0.05465061990973699
3396,3191,12,239,146,3588,0.06661092530657749
3397,1687,2,50,180,1919,0.026055237102657634
3398,8391,8,613,399,9411,0.06513654234406545
3399,1208,5,192,70,1475,0.13016949152542373
3400,1014,0,117,52,1183,0.0989010989010989
3401,380,2,82,19,483,0.16977225672877846
3402,10618,12,356,739,11725,0.030362473347547974
3403,901,3,121,61,1086,0.11141804788213629
3404,1790,2,56,55,1903,0.029427220178665267
3405,322,1,73,10,406,0.17980295566502463
3406,1257,5,224,48,1534,0.14602346805736635
3407,1313,5,120,145,1583,0.07580543272267846
3408,3308,7,153,255,3723,0.0410958904109589
3409,4857,7,407,530,5801,0.07016031718669195
3410,5502,7,606,385,6500,0.09323076923076923
3411,3685,4,266,289,4244,0.06267672007540057
3412,4323,9,284,234,4850,0.05855670103092783
3413,1848,4,88,185,2125,0.041411764705882356
3414,6591,4,315,436,7346,0.04288047917233869
3415,12772,21,563,1231,14587,0.03859601014602043
3416,5402,3,463,282,6150,0.07528455284552846
3417,1748,11,83,126,1968,0.04217479674796748
3418,3049,15,250,165,3479,0.07185972980741592
3419,3192,11,307,245,3755,0.08175765645805592
3420,18296,49,1460,1002,20807,0.0701686932282405
3421,11727,16,1314,589,13646,0.09629195368606185
3422,4663,19,300,317,5299,0.05661445555765239
3423,13032,0,65,537,13634,0.004767493032125568
3424,3963,9,366,139,4477,0.08175117266026356
3425,7028,20,898,414,8360,0.10741626794258373
3426,3745,5,775,149,4674,0.16581086863500213
3427,17251,15,1501,1279,20046,0.07487778110346203
3428,3539,5,369,188,4101,0.08997805413313825
3429,978,1,123,20,1122,0.10962566844919786
3430,6085,7,202,679,6973,0.028968879965581527
3431,904,1,62,71,1038,0.05973025048169557
3432,29436,14,628,995,31073,0.020210472114054003
3433,19147,17,706,1116,20986,0.0336414752692271
3434,963,6,120,40,1129,0.10628875110717449
3435,1094,5,89,94,1282,0.06942277691107644
3436,1507,2,92,56,1657,0.05552202776101388
3437,6999,4,278,389,7670,0.03624511082138201
3438,950,0,138,35,1123,0.12288512911843277
3439,657,0,80,21,758,0.10554089709762533
3440,2137,3,577,145,2862,0.2016072676450035
3441,3641,6,158,235,4040,0.03910891089108911
3442,6896,21,233,512,7662,0.030409814669799008
3443,585,3,170,36,794,0.2141057934508816
3444,12353,49,610,585,13597,0.04486283739060087
3445,2775,8,241,108,3132,0.07694763729246488
3446,4040,3,486,229,4758,0.1021437578814628
3447,2124,6,85,157,2372,0.03583473861720068
3448,5602,12,406,243,6263,0.06482516365958806
3449,103238,84,3109,5176,111607,0.02785667565654484
3450,1888,1,274,92,2255,0.12150776053215077
3451,4979,16,732,238,5965,0.12271584241408215
3452,1520,1,124,102,1747,0.07097882083571837
3453,3912,11,206,239,4368,0.04716117216117216
3454,6249,12,569,610,7440,0.07647849462365591
3455,13660,9,1208,685,15562,0.07762498393522684
3456,3151,6,207,193,3557,0.05819510823727861
3457,3326,7,190,301,3824,0.049686192468619245
3458,1171,0,205,65,1441,0.14226231783483692
3459,3144,1,104,143,3392,0.030660377358490566
3460,27129,48,7556,1472,36205,0.2087004557381577
3461,4206,3,923,282,5414,0.17048393055042482
3462,7699,13,830,679,9221,0.09001192929183385
3463,17368,26,453,676,18523,0.024456081628245963
3464,1173,4,157,65,1399,0.11222301644031452
3465,3821,4,327,289,4441,0.07363206485025896
3466,3459,2,187,288,3936,0.047510162601626015
3467,2544,4,305,124,2977,0.1024521330198186
3468,27046,63,3775,1487,32371,0.11661672484631305
3469,5337,14,326,462,6139,0.05310311125590487
3470,1204,4,266,90,1564,0.170076726342711
3471,3296,6,528,229,4059,0.13008130081300814
3472,23154,58,3798,1106,28116,0.1350832266325224
3473,24746,38,658,1927,27369,0.024041799115787934
3474,6402,7,229,470,7108,0.032217220033764774
3475,1978,2,70,129,2179,0.03212482790270767
3476,9649,14,998,639,11300,0.08831858407079646
3477,5367,11,837,340,6555,0.1276887871853547
3478,8000,7,197,793,8997,0.02189618761809492
3479,3151,7,260,216,3634,0.07154650522839846
3480,790,0,141,29,960,0.146875
3481,7402,19,262,526,8209,0.031916189548057014
3482,3642,13,463,305,4423,0.10468008139271988
3483,1968,7,73,128,2176,0.03354779411764706
3484,23011,27,1574,969,25581,0.06153004182791916
3485,662,2,133,29,826,0.16101694915254236
3486,31355,60,2866,1474,35755,0.08015662145154524
3487,914,0,60,48,1022,0.05870841487279843
3488,1210,2,136,106,1454,0.09353507565337002
3489,4481,3,152,313,4949,0.03071327540917357
3490,4799,9,237,353,5398,0.04390515005557614
3491,278150,469,10747,14769,304135,0.035336281585480134
3492,1336,3,80,80,1499,0.0533689126084056
3493,1910,2,255,85,2252,0.11323268206039076
3494,2570,5,99,161,2835,0.03492063492063492
3495,2211,3,116,76,2406,0.04821280133000831
3496,13636,24,1567,765,15992,0.09798649324662331
3497,25771,17,363,1882,28033,0.012949024364142261
3498,2721,3,83,222,3029,0.027401782766589635
3499,2965,5,154,280,3404,0.04524089306698002
3500,8335,16,233,474,9058,0.025723117686023405
3501,2186,1,215,72,2474,0.08690379951495554
3502,11246,14,1743,470,13473,0.12936985081273658
3503,1431,5,148,101,1685,0.08783382789317508
3504,3576,4,386,170,4136,0.09332688588007737
3505,676,2,39,64,781,0.0499359795134443
3506,2182,5,202,108,2497,0.08089707649179015
3507,48124,126,1777,3417,53444,0.033249756754733927
3508,6978,4,1190,405,8577,0.13874315028564765
3509,1110,0,289,64,1463,0.1975393028024607
3510,2832,6,336,115,3289,0.10215871085436302
3511,39047,54,909,3078,43088,0.021096360935759378
3512,1073,4,47,88,1212,0.038778877887788776
3513,3101,4,430,190,3725,0.11543624161073826
3514,874,2,103,62,1041,0.0989433237271854
3515,1394,0,275,170,1839,0.14953779227841218
3516,2180,2,331,66,2579,0.1283443195036836
3517,979,2,73,108,1162,0.06282271944922548
3518,20827,27,392,1013,22259,0.01761085403656948
3519,1561,5,175,87,1828,0.09573304157549234
3520,950,0,170,37,1157,0.14693171996542784
3521,8166,12,1522,587,10287,0.14795372800622145
3522,2366,6,288,209,2869,0.10038340885325897
3523,2308,4,281,226,2819,0.09968073785030153
3524,10252,7,1442,622,12323,0.11701696015580622
3525,1921,10,169,122,2222,0.07605760576057606
3526,45493,18,836,2473,48820,0.017124129455141336
3527,1436,4,145,75,1660,0.08734939759036145
3528,18468,21,467,1170,20126,0.02320381595945543
3529,5714,20,691,252,6677,0.1034895911337427
3530,1195,1,71,40,1307,0.05432287681713849
3531,3405,12,175,258,3850,0.045454545454545456
3532,489,0,50,33,572,0.08741258741258741
3533,3540,9,302,209,4060,0.07438423645320197
3534,1986,1,188,195,2370,0.07932489451476793
3535,2675,11,255,271,3212,0.07938978829389788
3536,12807,29,793,398,14027,0.056533827618164965
3537,3412,5,226,266,3909,0.05781529803018675
3538,2026,7,860,70,2963,0.290246371920351
3539,1527,3,55,131,1716,0.03205128205128205
3540,1133,5,125,65,1328,0.09412650602409639
3541,3972,29,424,210,4635,0.09147788565264293
3542,2076,5,169,144,2394,0.07059314954051796
3543,2455,1,93,341,2890,0.03217993079584775
3544,5020,11,398,224,5653,0.07040509464001415
3545,10796,40,1388,424,12648,0.10974067046173308
3546,2928,5,129,199,3261,0.03955841766329347
3547,39,9,293,1124,1465,0.2
3548,3410,3,394,133,3940,0.1
3549,1098,3,70,63,1234,0.05672609400324149
3550,1491,2,70,176,1739,0.04025301897642323
3551,25390,30,3110,891,29421,0.10570680806226845
3552,17893,34,2784,778,21489,0.12955465587044535
3553,2694,5,262,141,3102,0.08446163765312702
3554,3725,5,687,129,4546,0.15112186537615485
3555,5715,14,413,348,6490,0.06363636363636363
3556,61427,83,1589,7769,70868,0.022421967601738445
3557,1608,4,85,111,1808,0.04701327433628318
3558,1121,4,158,65,1348,0.1172106824925816
3559,4122,0,270,232,4624,0.05839100346020761
3560,4445,2,214,209,4870,0.04394250513347023
3561,6753,18,421,315,7507,0.05608099107499667
3562,4851,3,245,240,5339,0.04588874321033901
3563,4454,7,186,270,4917,0.037827943868212324
3564,1410,1,45,62,1518,0.029644268774703556
3565,1827,1,128,131,2087,0.061332055582175374
3566,2117,0,303,178,2598,0.11662817551963048
3567,11486,29,389,995,12899,0.030157376540817116
3568,816,1,35,32,884,0.03959276018099547
3569,378,1,48,25,452,0.10619469026548672
3570,1939,12,193,99,2243,0.08604547481052162
3571,3168,5,493,146,3812,0.12932843651626444
3572,11910,24,587,829,13350,0.04397003745318352
3573,1871,6,39,87,2003,0.019470793809286072
3574,3457,9,171,298,3935,0.0434561626429479
3575,985,4,53,65,1107,0.04787714543812105
3576,3027,7,480,182,3696,0.12987012987012986
3577,5350,2,429,321,6102,0.07030481809242871
3578,62516,109,4055,4072,70752,0.05731286748077793
3579,2088,8,271,92,2459,0.11020740138267589
3580,5312,2,232,231,5777,0.040159252207027867
3581,1386,1,69,101,1557,0.04431599229287091
3582,2354,8,89,137,2588,0.03438948995363215
3583,4048,6,626,223,4903,0.12767693249031206
3584,1348,6,141,77,1572,0.08969465648854962
3585,12614,5,260,812,13691,0.018990577751807756
3586,7180,17,1037,1083,9317,0.1113019212192766
3587,2822,3,87,102,3014,0.02886529528865295
3588,3971,7,444,160,4582,0.09690091663029245
3589,1279,2,99,25,1405,0.0704626334519573
3590,12850,8,568,636,14062,0.04039254729057033
3591,3496,5,393,119,4013,0.09793172190381261
3592,8326,4,1789,378,10497,0.17042964656568543
3593,6102,15,189,264,6570,0.028767123287671233
3594,1712,1,43,132,1888,0.022775423728813558
3595,19912,18,815,1494,22239,0.03664733126489501
3596,9003,30,348,786,10167,0.03422838595455887
3597,4848,6,220,469,5543,0.03968969871910518
3598,4173,14,130,192,4509,0.028831226436016856
3599,7397,3,152,809,8361,0.018179643583303432
3600,6907,8,729,337,7981,0.09134193710061396
3601,3845,5,495,148,4493,0.11017137769864234
3602,3478,8,397,244,4127,0.09619578386236977
3603,8877,17,664,344,9902,0.06705716016966269
3604,2073,2,197,181,2453,0.08030982470444353
3605,2990,3,189,192,3374,0.056016597510373446
3606,12555,9,230,745,13539,0.01698796070610828
3607,5067,10,927,390,6394,0.1449796684391617
3608,2981,4,460,102,3547,0.12968705948689033
3609,40803,89,3422,2065,46379,0.07378339334612648
3610,33259,64,1915,1602,36840,0.05198154180238871
3611,1673,5,138,64,1880,0.07340425531914893
3612,3535,3,460,188,4186,0.10989010989010989
3613,566,3,61,44,674,0.09050445103857567
3614,32369,33,5333,2313,40048,0.13316520175789054
3615,1402,6,91,69,1568,0.05803571428571429
3616,1969,6,29,134,2138,0.013564078578110383
3617,1583,0,30,75,1688,0.017772511848341232
3618,1215,3,158,49,1425,0.11087719298245614
3619,5086,14,483,292,5875,0.08221276595744681
3620,4654,6,449,494,5603,0.08013564162056042
3621,4930,5,1760,210,6905,0.2548877624909486
3622,3202,7,444,118,3771,0.1177406523468576
3623,40023,65,3983,3029,47100,0.08456475583864119
3624,6048,8,672,178,6906,0.09730668983492616
3625,2343,2,70,201,2616,0.026758409785932722
3626,2503,2,360,131,2996,0.12016021361815754
3627,11513,23,493,1056,13085,0.037676729079098206
3628,6566,20,566,380,7532,0.07514604354753053
3629,17325,17,505,1068,18915,0.02669838752312979
3630,5802,8,65,319,6194,0.010494026477236035
3631,3444,5,195,167,3811,0.05116767252689583
3632,1708,5,66,83,1862,0.03544575725026853
3633,1598,2,81,99,1780,0.04550561797752809
3634,2943,7,121,302,3373,0.035873109991105843
3635,18953,54,1261,966,21234,0.05938589055288688
3636,3138,5,496,178,3817,0.12994498297091958
3637,3867,6,197,236,4306,0.045750116117045984
3638,9017,8,180,390,9595,0.018759770713913496
3639,2875,7,152,309,3343,0.04546814238707748
3640,11165,25,830,745,12765,0.06502154328241284
3641,684,4,70,48,806,0.08684863523573201
3642,2815,0,198,179,3192,0.06203007518796992
3643,2351,1,488,126,2966,0.16453135536075522
3644,1254,0,175,128,1557,0.1123956326268465
3645,24419,31,1107,1365,26922,0.041118787608647206
3646,3115,0,189,134,3438,0.0549738219895288
3647,15036,23,1298,1593,17950,0.07231197771587744
3648,2284,0,314,107,2705,0.11608133086876156
3649,11600,18,1099,1178,13895,0.07909319899244333
3650,5246,3,707,324,6280,0.11257961783439491
3651,2166,2,135,86,2389,0.056508999581414816
3652,1835,2,54,132,2023,0.026693030153237766
3653,453,0,29,46,528,0.054924242424242424
3654,1911,9,92,134,2146,0.04287045666356011
3655,1327,6,116,94,1543,0.07517822423849643
3656,2807,8,189,140,3144,0.060114503816793896
3657,4071,4,1289,171,5535,0.23288166214995484
3658,6109,4,536,291,6940,0.07723342939481267
3659,70986,66,1719,5904,78675,0.021849380362249763
3660,975,2,170,83,1230,0.13821138211382114
3661,8374,15,775,458,9622,0.0805445853252962
3662,3000,5,268,138,3411,0.07856933450600997
3663,121926,190,16654,8525,147295,0.11306561661970875
3664,1389,2,166,70,1627,0.10202827289489859
3665,3811,27,362,198,4398,0.08231014097316962
3666,8715,21,374,294,9404,0.03977031050616759
3667,2058,7,310,80,2455,0.12627291242362526
3668,1452,10,139,56,1657,0.08388654194327097
3669,57241,33,2731,3334,63339,0.0431171947773094
3670,7782,7,1765,381,9935,0.17765475591343735
3671,7035,4,329,774,8142,0.04040776222058462
3672,1170,3,70,62,1305,0.05363984674329502
3673,4240,13,245,328,4826,0.05076668048072938
3674,14273,18,1045,850,16186,0.06456196713208946
3675,877,2,197,65,1141,0.1726555652936021
3676,3788,2,562,407,4759,0.11809203614204665
3677,304250,170,2929,16467,323816,0.009045260271265163
3678,85701,23,363,1724,87811,0.004133878443475191
3679,11803,27,433,845,13108,0.03303326212999695
3680,3310,8,345,208,3871,0.08912425729785585
3681,2890,1,133,144,3168,0.04198232323232323
3682,12293,12,396,1085,13786,0.028724793268533295
3683,6697,16,798,389,7900,0.1010126582278481
3684,2733,8,129,133,3003,0.04295704295704296
3685,2337,1,187,165,2690,0.06951672862453531
3686,13844,39,1296,705,15884,0.08159153865525057
3687,1633,7,261,91,1992,0.13102409638554216
3688,5587,12,215,293,6107,0.03520550188308499
3689,10364,23,556,756,11699,0.04752542952389093
3690,2637,6,449,128,3220,0.13944099378881988
3691,702,0,56,34,792,0.0707070707070707
3692,3578,6,282,152,4018,0.07018417122946739
3693,3294,21,320,186,3821,0.08374771002355404
3694,1133,4,118,57,1312,0.0899390243902439
3695,24971,15,427,2218,27631,0.015453657124244508
3696,12352,10,796,1290,14448,0.05509413067552602
3697,13480,24,647,868,15019,0.043078766895266
3698,292079,360,4767,21866,319072,0.014940201584595327
3699,2100,2,183,295,2580,0.07093023255813953
3700,5512,1,99,569,6181,0.016016825756350106
3701,4029,9,278,257,4573,0.06079160288650776
3702,832,3,92,69,996,0.09236947791164658
3703,5348,4,350,349,6051,0.05784167906131218
3704,1439,3,96,158,1696,0.05660377358490566
3705,890,6,80,37,1013,0.07897334649555775
3706,30678,61,2697,1960,35396,0.07619505028816816
3707,1903,1,177,126,2207,0.08019936565473493
3708,3435,15,140,221,3811,0.036735764891104694
3709,2056,4,323,93,2476,0.13045234248788368
3710,719,3,47,14,783,0.06002554278416347
3711,542,1,32,45,620,0.05161290322580645
3712,2154,8,150,130,2442,0.06142506142506143
3713,2441,5,280,104,2830,0.0989399293286219
3714,10377,14,368,696,11455,0.03212570929725011
3715,5038,14,505,339,5896,0.08565128900949796
3716,35522,111,2009,1299,38941,0.051590868236563
3717,1912,2,25,82,2021,0.012370113805047007
3718,9155,5,303,734,10197,0.029714621947631657
3719,4043,12,182,350,4587,0.03967734902986701
3720,1288,5,98,91,1482,0.06612685560053981
3721,14764,23,891,928,16606,0.05365530531133325
3722,4892,10,258,654,5814,0.04437564499484004
3723,5002,8,631,283,5924,0.10651586765698852
3724,4760,14,283,262,5319,0.0532054897537131
3725,11339,4,367,1151,12861,0.02853588367934064
3726,3474,8,196,310,3988,0.04914744232698094
3727,20946,39,919,1658,23562,0.03900348017995077
3728,1697,2,383,97,2179,0.17576870123910052
3729,31877,50,4274,2294,38495,0.11102740615664372
3730,2100,1,484,77,2662,0.18181818181818182
3731,672,7,38,35,752,0.05053191489361702
3732,6448,3,744,473,7668,0.09702660406885759
3733,3025,7,192,179,3403,0.05642080517190714
3734,92707,371,7007,4536,104621,0.06697508148459679
3735,7378,14,209,759,8360,0.025
3736,15578,9,1865,1067,18519,0.10070738160807818
3737,2019,1,291,115,2426,0.11995053586150041
3738,1910,2,84,125,2121,0.039603960396039604
3739,1442,2,205,86,1735,0.11815561959654179
3740,7989,12,239,330,8570,0.027887981330221703
3741,17758,32,3725,938,22453,0.16590210662272303
3742,2842,4,334,221,3401,0.09820640987944722
3743,6573,13,779,269,7634,0.10204348965155882
3744,3346,4,359,191,3900,0.09205128205128205
3745,2504,5,70,213,2792,0.025071633237822348
3746,1814,0,222,90,2126,0.10442144873000941
3747,1677,2,57,113,1849,0.030827474310438075
3748,2938,4,209,262,3413,0.061236448871960156
3749,5428,6,704,265,6403,0.10994846165859753
3750,10159,19,192,831,11201,0.017141326667261852
3751,6332,7,484,306,7129,0.06789170991723945
3752,4452,6,347,267,5072,0.06841482649842272
3753,2643,14,505,87,3249,0.1554324407510003
3754,3341,11,436,192,3980,0.10954773869346733
3755,7582,4,191,580,8357,0.022855091540026327
3756,2923,10,207,210,3350,0.0617910447761194
3757,4846,9,719,192,5766,0.12469649670482137
3758,15243,20,1191,659,17113,0.06959621340501373
3759,3862,8,93,283,4246,0.02190296749882242
3760,679703,682,17931,44901,743217,0.02412619732864022
3761,3468,5,233,270,3976,0.05860160965794769
3762,2976,8,126,111,3221,0.039118286246507296
3763,1932,4,353,60,2349,0.1502767134951043
3764,1593,1,344,82,2020,0.1702970297029703
3765,2924,3,77,191,3195,0.02410015649452269
3766,9389,11,1184,607,11191,0.1057993030113484
3767,5603,5,1459,361,7428,0.19641895530425418
3768,1401,4,78,67,1550,0.05032258064516129
3769,7893,11,803,399,9106,0.08818361519877004
3770,3486,0,144,192,3822,0.03767660910518053
3771,1814,4,196,125,2139,0.09163160355306219
3772,2120,4,271,76,2471,0.10967219749089438
3773,5975,15,348,507,6845,0.0508400292184076
3774,1220,0,199,99,1518,0.1310935441370224
3775,1540,4,89,131,1764,0.05045351473922902
3776,1547,0,202,80,1829,0.11044286495352652
3777,3376,1,134,414,3925,0.03414012738853503
3778,1420,1,48,164,1633,0.029393753827311696
3779,1153,0,189,42,1384,0.1365606936416185
3780,4191,9,607,323,5130,0.11832358674463937
3781,2959,2,300,199,3460,0.08670520231213873
3782,1235,3,72,83,1393,0.05168700646087581
3783,7234,17,1297,473,9021,0.14377563463030707
3784,3776,12,112,166,4066,0.027545499262174127
3785,2889,4,338,153,3384,0.09988179669030733
3786,11930,14,321,993,13258,0.024211796651078595
3787,948,0,31,65,1044,0.029693486590038315
3788,2112,5,123,146,2386,0.05155071248952221
3789,1248,2,115,43,1408,0.08167613636363637
3790,9148,33,1057,626,10864,0.09729381443298969
3791,6308,20,1095,369,7792,0.14052874743326488
3792,3844,7,175,335,4361,0.04012841091492777
3793,3208,6,293,183,3690,0.07940379403794037
3794,2520,5,148,204,2877,0.05144247480013903
3795,4948,11,315,366,5640,0.05585106382978723
3796,6357,11,848,454,7670,0.1105606258148631
3797,18521,30,1149,1208,20908,0.05495504113258083
3798,1199,2,247,65,1513,0.16325181758096496
3799,1903,4,124,154,2185,0.056750572082379866
3800,2478,5,589,77,3149,0.18704350587488092
3801,690,2,27,78,797,0.033877038895859475
3802,4862,7,392,302,5563,0.0704655761279885
3803,5271,10,201,499,5981,0.03360642033104832
3804,1000,2,155,98,1255,0.12350597609561753
3805,2819,2,362,241,3424,0.10572429906542057
3806,862,1,283,16,1162,0.24354561101549052
3807,601,2,45,35,683,0.06588579795021962
3808,210,0,13,12,235,0.05531914893617021
3809,4937,9,296,143,5385,0.05496750232126277
3810,1809,2,55,156,2022,0.027200791295746787
3811,2761,3,199,181,3144,0.06329516539440204
3812,4006,4,251,212,4473,0.05611446456516879
3813,3508,2,76,194,3780,0.020105820105820106
3814,483,0,104,15,602,0.17275747508305647
3815,6167,13,375,251,6806,0.05509844255069057
3816,3552,7,212,219,3990,0.053132832080200504
3817,7086,4,141,687,7918,0.017807527153321547
3818,8425,24,602,661,9712,0.06198517298187809
3819,6642,23,467,335,7467,0.06254185081023168
3820,8697,20,376,708,9801,0.03836343230282624
3821,4721,4,124,302,5151,0.024072995534847604
3822,14369,24,703,1102,16198,0.043400419804914186
3823,952,1,56,86,1095,0.05114155251141553
3824,1195,2,97,63,1357,0.07148120854826824
3825,4517,1,608,217,5343,0.11379374883024518
3826,22593,95,3457,1074,27219,0.12700687020096257
3827,1471,0,55,141,1667,0.032993401319736056
3828,667956,900,18877,42722,730455,0.025842796613069936
3829,1025,0,142,35,1202,0.11813643926788686
3830,1310,0,108,59,1477,0.07312119160460392
3831,1521,1,112,57,1691,0.06623299822590184
3832,1132,8,71,67,1278,0.05555555555555555
3833,8093,22,1082,1075,10272,0.10533489096573209
3834,21689,10,591,397,22687,0.026050160885088377
3835,18423,30,1376,686,20515,0.06707287350718986
3836,1708,3,174,79,1964,0.08859470468431772
3837,1791,1,203,138,2133,0.09517112048757619
3838,4738,1,888,268,5895,0.15063613231552161
3839,31380,77,1015,1404,33876,0.029962215137560515
3840,1882,2,136,174,2194,0.06198723792160438
3841,1272,3,78,77,1430,0.05454545454545454
3842,1194,2,147,68,1411,0.1041814316087881
3843,5386,20,387,261,6054,0.0639246778989098
3844,11206,11,788,565,12570,0.06268894192521877
3845,60279,90,3611,3357,67337,0.053625792654855425
3846,2183,4,188,84,2459,0.07645384302562017
3847,3114,9,209,224,3556,0.05877390326209224
3848,8317,24,175,469,8985,0.019476905954368393
3849,2080,4,427,116,2627,0.1625428245146555
3850,1002,4,57,61,1124,0.050711743772241996
3851,3370,4,398,240,4012,0.0992023928215354
3852,558,0,244,34,836,0.291866028708134
3853,24700,26,661,1411,26798,0.02466601985222778
3854,6042,5,627,361,7035,0.08912579957356077
3855,3527,2,249,272,4050,0.061481481481481484
3856,908,2,125,22,1057,0.11825922421948912
3857,1147,7,71,54,1279,0.05551211884284597
3858,8943,4,188,462,9597,0.019589455038032718
3859,63865,187,7791,3889,75732,0.10287593091427666
3860,4765,8,184,352,5309,0.03465812770766623
3861,28199,49,1514,908,30670,0.04936419954352788
3862,6348,8,1258,231,7845,0.16035691523263226
3863,4984,23,304,280,5591,0.05437309962439635
3864,2050,0,128,115,2293,0.055822067160924554
3865,3361,4,690,132,4187,0.16479579651301648
3866,3541,8,101,332,3982,0.025364138623807132
3867,3829,20,215,234,4298,0.050023266635644485
3868,1275,3,135,45,1458,0.09259259259259259
3869,2610,1,54,178,2843,0.018994020400984874
3870,4959,2,74,192,5227,0.014157260378802373
3871,4347,8,147,266,4768,0.03083053691275168
3872,2277,2,403,162,2844,0.14170182841068918
3873,1706,4,133,73,1916,0.06941544885177453
3874,9396,6,203,871,10476,0.01937762504772814
3875,6122,6,835,482,7445,0.11215580926796508
3876,766,4,82,17,869,0.09436133486766399
3877,20028,24,886,987,21925,0.04041049030786773
3878,24899,24,835,1392,27150,0.030755064456721916
3879,1080,3,110,113,1306,0.08422664624808576
3880,4667,7,366,162,5202,0.07035755478662054
3881,4135,2,278,145,4560,0.06096491228070176
3882,4229,3,179,307,4718,0.03793980500211954
3883,10502,23,555,430,11510,0.04821894005212858
3884,6143,3,96,478,6720,0.014285714285714285
3885,2718,7,346,118,3189,0.10849796174349326
3886,774,0,100,100,974,0.1026694045174538
3887,15873,10,373,1042,17298,0.021563186495548618
3888,8406,9,894,711,10020,0.08922155688622754
3889,2211,6,312,145,2674,0.11667913238593867
3890,5317,4,102,525,5948,0.01714862138533961
3891,1114,4,224,41,1383,0.16196673897324657
3892,2780,3,129,140,3052,0.042267365661861074
3893,6059,8,384,339,6790,0.05655375552282769
3894,2122,3,138,287,2550,0.05411764705882353
3895,1564,4,56,59,1683,0.033273915626856804
3896,2746,3,74,274,3097,0.02389409105586051
3897,4241,9,484,345,5079,0.09529434928135459
3898,14715,52,1550,640,16957,0.09140767824497258
3899,1630,0,67,117,1814,0.03693495038588754
3900,1629,2,135,153,1919,0.07034914017717561
3901,4754,9,464,273,5500,0.08436363636363636
3902,2529,4,190,135,2858,0.06648005598320504
3903,2614,4,106,92,2816,0.037642045454545456
3904,19151,31,407,1403,20992,0.019388338414634148
3905,3144,5,235,148,3532,0.06653454133635334
3906,14870,28,410,961,16269,0.025201303091769624
3907,7068,13,366,501,7948,0.04604932058379466
3908,1638,1,123,136,1898,0.06480505795574289
3909,2866,4,60,146,3076,0.01950585175552666
3910,23588,47,1945,1763,27343,0.07113337965841349
3911,1248,0,169,53,1470,0.11496598639455782
3912,10329,17,2099,378,12823,0.16369024409264601
3913,4432,4,184,273,4893,0.03760474146740241
3914,10350,15,605,345,11315,0.053468846663720725
3915,3303,9,320,306,3938,0.08125952260030472
3916,3562,8,222,165,3957,0.056103108415466264
3917,3269,0,358,102,3729,0.09600429069455618
3918,20960,28,931,581,22500,0.04137777777777778
3919,9562,9,1314,733,11618,0.11310036150800482
3920,6821,9,959,618,8407,0.11407160699417153
3921,1535,3,53,121,1712,0.030957943925233645
3922,5127,10,282,258,5677,0.04967412365686102
3923,2145,11,202,165,2523,0.08006341656757827
3924,7177,6,286,380,7849,0.036437762772327686
3925,94973,96,2209,5479,102757,0.021497318917446013
3926,2642,4,447,74,3167,0.1411430375749921
3927,1072,3,57,107,1239,0.04600484261501211
3928,511,0,37,20,568,0.06514084507042253
3929,4549,5,544,163,5261,0.10340239498194259
3930,2751,4,331,110,3196,0.10356695869837297
3931,6621,7,244,537,7409,0.0329329194223242
3932,9950,15,173,632,10770,0.01606313834726091
3933,582,1,88,16,687,0.12809315866084425
3934,2087,3,66,98,2254,0.029281277728482696
3935,8501,13,1363,166,10043,0.13571641939659465
3936,20663,82,1967,1209,23921,0.0822290038041888
3937,11320,19,452,1030,12821,0.03525466032290773
3938,7087,17,1029,461,8594,0.11973469862694903
3939,2017,3,64,51,2135,0.029976580796252927
3940,1166,8,116,51,1341,0.08650260999254288
3941,28992,33,884,1705,31614,0.027962295185677232
3942,476,0,48,45,569,0.0843585237258348
3943,1106,7,60,59,1232,0.048701298701298704
3944,1122,2,136,67,1327,0.10248681235870384
3945,1954,1,202,106,2263,0.08926204153778171
3946,5221,10,136,553,5920,0.022972972972972974
3947,5087,8,1130,347,6572,0.17194157029823492
3948,10670,12,1404,480,12566,0.11173006525545122
3949,13937,21,2168,1072,17198,0.12606116990347715
3950,10992,13,254,412,11671,0.02176334504326964
3951,28237,38,3572,1924,33771,0.10577122383109769
3952,2039,5,306,69,2419,0.12649855312112443
3953,2964,13,134,143,3254,0.041180086047940996
3954,9278,21,1564,234,11097,0.14093899252050104
3955,83681,71,9966,3912,97630,0.10207927891017106
3956,8488,13,1000,595,10096,0.09904912836767037
3957,8833,18,900,483,10234,0.08794215360562829
3958,19527,23,576,1431,21557,0.026719858978522058
3959,4595,3,626,149,5373,0.11650846826726224
3960,3423,4,213,155,3795,0.05612648221343874
3961,7961,8,160,480,8609,0.018585201533279125
3962,4346,19,61,346,4772,0.01278290025146689
3963,10157,26,961,933,12077,0.07957274157489443
3964,6830,7,196,167,7200,0.02722222222222222
3965,11194,18,1899,397,13508,0.1405833580100681
3966,670,0,116,36,822,0.1411192214111922
3967,933,2,85,45,1065,0.07981220657276995
3968,12477,40,2243,789,15549,0.14425364975239566
3969,4769,11,361,586,5727,0.06303474768639776
3970,60959,61,1684,3033,65737,0.025617232304486058
3971,24602,94,2608,1588,28892,0.09026720199363146
3972,3176,4,90,272,3542,0.025409373235460192
3973,2163,3,42,230,2438,0.017227235438884332
3974,1133,5,99,89,1326,0.0746606334841629
3975,9269,9,612,547,10437,0.0586375395228514
3976,2361,6,462,111,2940,0.15714285714285714
3977,1026,2,56,45,1129,0.049601417183348095
3978,7317,11,621,321,8270,0.0750906892382104
3979,9563,26,905,607,11101,0.08152418701017926
3980,8291,14,367,388,9060,0.040507726269315675
3981,6480,4,284,599,7367,0.0385502918419981
3982,2860,10,244,162,3276,0.07448107448107448
3983,2421,5,441,192,3059,0.14416475972540047
3984,36267,65,1200,2132,39664,0.030254134731746672
3985,12734,34,1702,833,15303,0.11122002221786578
3986,3187,12,431,109,3739,0.11527146295801016
3987,2319,0,438,100,2857,0.15330766538326918
3988,3484,9,60,117,3670,0.01634877384196185
3989,5859,4,838,368,7069,0.11854576319139906
3990,74285,131,2660,4328,81404,0.03267652695199253
3991,6630,10,120,298,7058,0.01700198356474922
3992,9612,14,1155,658,11439,0.1009703645423551
3993,1274,0,121,61,1456,0.0831043956043956
3994,3554,6,215,214,3989,0.053898220105289545
3995,12581,14,3413,722,16730,0.2040047818290496
3996,1244,7,123,52,1426,0.08625525946704067
3997,23100,21,154,1322,24597,0.006260926129202748
3998,1620,0,169,94,1883,0.08975039830058418
3999,2454,6,204,179,2843,0.07175518818149841
4000,1882,0,285,158,2325,0.12258064516129032
4001,7908,21,252,761,8942,0.0281816148512637
4002,4532,5,355,279,5171,0.06865209824018564
4003,8542,8,491,514,9555,0.05138670852956567
4004,1699,0,77,85,1861,0.04137560451370231
4005,3513,5,535,95,4148,0.1289778206364513
4006,11037,20,380,602,12039,0.03156408339563087
4007,1411,4,209,84,1708,0.12236533957845433
4008,3423,12,155,230,3820,0.04057591623036649
4009,11185,18,460,383,12046,0.038186950024904534
4010,4131,3,328,182,4644,0.07062876830318691
4011,1081,4,76,88,1249,0.06084867894315452
4012,2834,5,282,174,3295,0.08558421851289832
4013,3952,6,546,202,4706,0.11602209944751381
4014,527,1,43,49,620,0.06935483870967742
4015,2669,12,337,160,3178,0.10604153555695406
4016,2397,12,131,103,2643,0.04956488838441166
4017,1210,12,65,99,1386,0.046897546897546896
4018,2317,1,137,133,2588,0.05293663060278207
4019,1004,1,97,38,1140,0.08508771929824561
4020,3397,3,221,185,3806,0.058066211245402
4021,7952,7,1425,312,9696,0.1469678217821782
4022,7031,18,874,427,8350,0.10467065868263473
4023,726,1,109,25,861,0.12659698025551683
4024,7625,28,1660,374,9687,0.17136368328687931
4025,1138,1,270,55,1464,0.18442622950819673
4026,24713,32,2022,1051,27818,0.07268674958659861
4027,1910,2,76,168,2156,0.03525046382189239
4028,6609,2,471,446,7528,0.0625664187035069
4029,2352,4,115,88,2559,0.044939429464634625
4030,2193,4,100,162,2459,0.040666937779585195
4031,1584,2,121,83,1790,0.06759776536312849
4032,3213,10,263,274,3760,0.0699468085106383
4033,4044,6,307,280,4637,0.06620659909424197
4034,2268,2,357,156,2783,0.1282788357887172
4035,10377,10,1303,263,11953,0.10901029030368944
4036,4091,6,261,442,4800,0.054375
4037,2082,5,185,145,2417,0.07654116673562267
4038,898,3,97,66,1064,0.09116541353383459
4039,4898,6,480,261,5645,0.08503100088573959
4040,6747,29,661,574,8011,0.08251154662339283
4041,8849,26,302,679,9856,0.030641233766233768
4042,22424,33,3533,1247,27237,0.12971325770092154
4043,52325,105,7713,3988,64131,0.12026944847265753
4044,460527,585,12855,30529,504496,0.025480875963337667
4045,2414,2,229,151,2796,0.08190271816881259
4046,2255,4,138,191,2588,0.05332302936630603
4047,5731,8,764,383,6886,0.11094975312227709
4048,25959,66,4923,1826,32774,0.15021053273936658
4049,19112,41,2778,1459,23390,0.11876870457460453
4050,4238,1,911,167,5317,0.17133722023697573
4051,622,3,68,32,725,0.09379310344827586
4052,3090,3,748,149,3990,0.187468671679198
4053,4904,11,313,383,5611,0.055783282837283905
4054,1142,3,36,73,1254,0.028708133971291867
4055,1754,6,89,151,2000,0.0445
4056,1571,3,209,89,1872,0.11164529914529915
4057,5594,6,143,321,6064,0.02358179419525066
4058,3611,5,277,275,4168,0.06645873320537428
4059,2289,8,126,117,2540,0.049606299212598425
4060,4598,8,289,171,5066,0.05704697986577181
4061,2134,2,114,85,2335,0.048822269807280515
4062,5669,9,247,478,6403,0.03857566765578635
4063,2347,6,89,203,2645,0.03364839319470699
4064,14241,23,908,2525,17697,0.05130813132169294
4065,1466,2,44,77,1589,0.027690371302706105
4066,5394,15,742,287,6438,0.11525318421870145
4067,12985,8,333,910,14236,0.02339140207923574
4068,2168,2,134,213,2517,0.05323798172427493
4069,2053,2,397,83,2535,0.15660749506903354
4070,11565,17,211,857,12650,0.016679841897233202
4071,3419,14,772,118,4323,0.1785796900300717
4072,9168,34,432,977,10611,0.04071246819338423
4073,22114,30,696,1965,24805,0.028058859100987703
4074,4440,13,443,268,5164,0.08578621223857474
4075,1363,1,143,141,1648,0.08677184466019418
4076,2310,6,180,109,2605,0.0690978886756238
4077,4789,5,301,290,5385,0.05589600742804086
4078,3616,6,293,307,4222,0.06939838938891521
4079,29063,57,6830,1208,37158,0.18380967759298134
4080,2907,12,112,233,3264,0.03431372549019608
4081,2079,4,135,89,2307,0.05851755526657997
4082,1600,2,72,126,1800,0.04
4083,16003,32,1043,777,17855,0.05841500980117614
4084,5256,9,726,341,6332,0.11465571699305117
4085,766,1,98,37,902,0.10864745011086474
4086,7091,14,513,485,8103,0.06330988522769344
4087,4271,7,511,185,4974,0.10273421793325292
4088,4820,10,117,191,5138,0.022771506422732582
4089,717,0,108,39,864,0.125
4090,35729,97,2324,2712,40862,0.05687435759385248
4091,11971,15,2592,662,15240,0.1700787401574803
4092,5895,1,489,323,6708,0.07289803220035779
4093,1952,4,272,40,2268,0.11992945326278659
4094,195757,250,3813,11379,211199,0.01805406275597896
4095,1784,3,75,109,1971,0.0380517503805175
4096,4121,9,663,382,5175,0.12811594202898552
4097,2518,4,227,132,2881,0.0787920860812218
4098,6775,9,110,461,7355,0.01495581237253569
4099,9908,13,794,599,11314,0.07017853986211774
4100,2734,7,184,204,3129,0.05880472994566954
4101,937,1,66,48,1052,0.06273764258555133
4102,4580,8,725,145,5458,0.13283253939171857
4103,185,1,13,11,210,0.06190476190476191
4104,2905,6,247,177,3335,0.07406296851574212
4105,2851,1,405,127,3384,0.1196808510638298
4106,5626,10,263,461,6360,0.04135220125786163
4107,3001,5,245,123,3374,0.07261410788381743
4108,1590,8,109,163,1870,0.058288770053475936
4109,3422,7,564,228,4221,0.13361762615493958
4110,1816,6,247,108,2177,0.11345888837850253
4111,10645,18,507,480,11650,0.04351931330472103
4112,1614,8,179,117,1918,0.09332638164754953
4113,743,3,51,32,829,0.061519903498190594
4114,3821,0,542,174,4537,0.11946219969142605
4115,9561,24,1104,460,11149,0.09902233384160014
4116,2430,4,182,119,2735,0.06654478976234003
4117,3572,10,171,191,3944,0.04335699797160243
4118,8186,9,1549,381,10125,0.15298765432098765
4119,2329,4,253,199,2785,0.09084380610412926
4120,4302,3,220,178,4703,0.04677865192430364
4121,1004,2,266,95,1367,0.19458668617410388
4122,8808,20,251,555,9634,0.026053560307245174
4123,3499,10,136,252,3897,0.03489863997947139
4124,1234,1,85,85,1405,0.060498220640569395
4125,10267,12,1019,620,11918,0.0855009229736533
4126,16375,29,1545,924,18873,0.08186297885868701
4127,70868,201,4118,4326,79513,0.05179027328864463
4128,2203,6,212,87,2508,0.08452950558213716
4129,27973,18,1479,1421,30891,0.047878022725065555
4130,2061,3,180,174,2418,0.07444168734491315
4131,13084,28,1209,1339,15660,0.07720306513409962
4132,8477,19,184,761,9441,0.0194894608621968
4133,4765,1,397,233,5396,0.07357301704966641
4134,3331,7,202,333,3873,0.052155951458817455
4135,3964,8,219,354,4545,0.048184818481848184
4136,5480,6,503,441,6430,0.07822706065318819
4137,5414,8,747,597,6766,0.1104049660065031
4138,10333,8,1451,551,12343,0.11755650976261849
4139,1694,7,89,180,1970,0.04517766497461929
4140,7744,11,229,582,8566,0.0267335979453654
4141,3997,6,117,285,4405,0.02656072644721907
4142,2499,6,179,92,2776,0.06448126801152737
4143,77171,64,1710,3730,82675,0.020683398850922286
4144,11360,7,2773,343,14483,0.19146585652143894
4145,1607,9,158,250,2024,0.07806324110671936
4146,2358,10,112,144,2624,0.042682926829268296
4147,765,0,100,19,884,0.11312217194570136
4148,3019,5,260,217,3501,0.07426449585832619
4149,1811,0,150,88,2049,0.07320644216691069
4150,4846,11,693,377,5927,0.11692255778640122
4151,2241,7,189,105,2542,0.07435090479937058
4152,4839,8,368,195,5410,0.06802218114602587
4153,2493,7,194,199,2893,0.0670584168683028
4154,8809,7,501,545,9862,0.05080105455282904
4155,621,4,63,33,721,0.08737864077669903
4156,1185,3,39,66,1293,0.030162412993039442
4157,1853,2,388,100,2343,0.16559965855740505
4158,4911,5,816,363,6095,0.1338802296964725
4159,7809,23,1083,300,9215,0.11752577319587629
4160,41574,59,8272,3486,53391,0.1549324792568036
4161,41300,45,4177,6747,52269,0.07991352426868699
4162,1042,2,113,50,1207,0.0936205468102734
4163,13769,35,569,1049,15422,0.03689534431331864
4164,6073,29,681,434,7217,0.0943605376195095
4165,1175,1,87,55,1318,0.06600910470409711
4166,2505,2,362,286,3155,0.11473851030110935
4167,1592,5,97,97,1791,0.05415968732551647
4168,1182,3,287,154,1626,0.17650676506765067
4169,4016,7,554,207,4784,0.11580267558528429
4170,22557,74,3749,746,27126,0.13820688638206888
4171,7801,22,3046,227,11096,0.2745133381398702
4172,1578,0,170,84,1832,0.0927947598253275
4173,486770,753,10806,30426,528755,0.020436686177908482
4174,2339,1,188,142,2670,0.07041198501872659
4175,11441,13,218,766,12438,0.017526933590609424
4176,1018,3,108,50,1179,0.0916030534351145
4177,2267,3,263,122,2655,0.09905838041431261
4178,2547,3,235,275,3060,0.07679738562091504
4179,5327,11,230,290,5858,0.03926254694434961
4180,2358,1,334,228,2921,0.11434440260184868
4181,2283,3,292,99,2677,0.10907732536421368
4182,13,12,288,543,856,0.3364485981308411
4183,2724,8,131,164,3027,0.04327717211760819
4184,2381,7,107,197,2692,0.03974739970282318
4185,4680,13,523,240,5456,0.09585777126099707
4186,14478,21,437,636,15572,0.02806319034163884
4187,17878,54,1887,1107,20926,0.090174902035745
4188,18236,52,1373,1786,21447,0.06401827761458478
4189,1387,2,66,109,1564,0.04219948849104859
4190,1010,3,63,55,1131,0.05570291777188329
4191,4310,18,220,284,4832,0.04552980132450331
4192,13498,29,1547,718,15792,0.09796099290780141
4193,6881,5,726,365,7977,0.09101165851823995
4194,1783,3,97,82,1965,0.04936386768447837
4195,2074,4,247,83,2408,0.10257475083056479
4196,3977,9,615,108,4709,0.130600976852835
4197,3694,9,510,158,4371,0.11667810569663692
4198,5869,15,1020,442,7346,0.13885107541519195
4199,1468,4,281,288,2041,0.13767760901518863
4200,5139,16,438,345,5938,0.07376220949814752
4201,1303,2,80,55,1440,0.05555555555555555
4202,2149,2,224,106,2481,0.09028617492946392
4203,814,2,67,27,910,0.07362637362637363
4204,1784,3,57,176,2020,0.02821782178217822
4205,51217,95,4873,2866,59051,0.08252188785964674
4206,1605,7,130,75,1817,0.07154650522839846
4207,651,0,78,31,760,0.10263157894736842
4208,1681,4,79,171,1935,0.04082687338501292
4209,3953,12,315,210,4490,0.07015590200445435
4210,536,7,91,47,681,0.13362701908957417
4211,2593,7,175,131,2906,0.060220233998623536
4212,6904,22,636,368,7930,0.08020176544766709
4213,2046,3,521,87,2657,0.19608581106511103
4214,2593,3,461,211,3268,0.14106487148102814
4215,116,0,31,6,153,0.20261437908496732
4216,2041,7,184,105,2337,0.0787334189131365
4217,2817,6,576,126,3525,0.16340425531914893
4218,128220,279,7438,6924,142861,0.05206459425595509
4219,7284,16,378,425,8103,0.04664938911514254
4220,8055,11,808,417,9291,0.08696588096006888
4221,5158,13,947,310,6428,0.14732420659614187
4222,1619,0,152,83,1854,0.08198489751887811
4223,2621,13,210,126,2970,0.0707070707070707
4224,7331,5,229,261,7826,0.029261436238180425
4225,755,4,154,43,956,0.16108786610878661
4226,737,1,34,51,823,0.041312272174969626
4227,1082,2,34,142,1260,0.026984126984126985
4228,2681,0,107,141,2929,0.036531239330829635
4229,1558,3,144,70,1775,0.08112676056338028
4230,877,2,130,88,1097,0.11850501367365543
4231,2918,3,141,310,3372,0.04181494661921708
4232,5660,20,511,274,6465,0.07904098994586234
4233,8377,9,396,623,9405,0.042105263157894736
4234,44361,57,3781,2298,50497,0.07487573519218964
4235,7203,13,212,477,7905,0.026818469323213155
4236,2189,1,235,92,2517,0.09336511720301947
4237,5191,11,122,441,5765,0.021162185602775368
4238,17884,39,836,593,19352,0.04319966928482844
4239,9273,14,1442,593,11322,0.1273626567744215
4240,5629,12,457,322,6420,0.07118380062305296
4241,2593,0,191,128,2912,0.06559065934065934
4242,1347,2,129,93,1571,0.08211330362826226
4243,7020,9,482,314,7825,0.06159744408945687
4244,12757,31,2073,1175,16036,0.12927163881267148
4245,4534,13,395,301,5243,0.07533854663360671
4246,26987,13,415,988,28403,0.014611132626835194
4247,894,3,101,27,1025,0.09853658536585366
4248,2044,3,294,173,2514,0.11694510739856802
4249,10589,18,600,899,12106,0.04956220056170494
4250,6388,4,37,588,7017,0.005272908650420407
4251,9137,28,2198,544,11907,0.18459729570840683
4252,3315,5,383,197,3900,0.09820512820512821
4253,2550,2,335,166,3053,0.10972813625941696
4254,12526,25,578,1150,14279,0.04047902514181665
4255,26202,18,8386,879,35485,0.23632520783429617
4256,18663,22,1067,916,20668,0.0516257015676408
4257,170608,321,3085,10966,184980,0.016677478646340144
4258,2044,8,149,109,2310,0.0645021645021645
4259,5122,6,172,567,5867,0.02931651610703937
4260,6526,16,745,511,7798,0.09553731726083611
4261,1827,6,305,105,2243,0.1359786000891663
4262,1170,0,114,31,1315,0.08669201520912548
4263,1516,3,147,60,1726,0.08516801853997683
4264,1465,0,85,103,1653,0.0514216575922565
4265,33302,47,866,1348,35563,0.024351151477659365
4266,3716,3,504,226,4449,0.11328388401888065
4267,31774,32,1419,1075,34300,0.041370262390670556
4268,2683,17,212,255,3167,0.06694032207136091
4269,4128,7,249,168,4552,0.054701230228471
4270,16599,29,1449,859,18936,0.07652091254752852
4271,2679,3,143,137,2962,0.04827819041188386
4272,4912,11,627,605,6155,0.10186839967506092
4273,10271,9,281,560,11121,0.025267511914396187
4274,10965,31,981,1169,13146,0.07462345960748516
4275,2825,1,205,221,3252,0.06303813038130382
4276,9365,18,1154,439,10976,0.10513848396501457
4277,3641,8,332,229,4210,0.07885985748218527
4278,3085,11,378,118,3592,0.10523385300668152
4279,3838,4,649,301,4792,0.1354340567612688
4280,16341,47,1025,1752,19165,0.05348291155752674
4281,5845,16,459,368,6688,0.06863038277511961
4282,128058,175,5050,5559,138842,0.03637227928148543
4283,9911,20,883,518,11332,0.07792093187433816
4284,1111,0,148,49,1308,0.11314984709480122
4285,4058,2,364,249,4673,0.07789428632570083
4286,2049,3,137,134,2323,0.05897546276366767
4287,38154,57,4933,3127,46271,0.10661105227896522
4288,1017,3,59,79,1158,0.05094991364421416
4289,11294,15,1182,405,12896,0.09165632754342432
4290,2634,4,115,198,2951,0.03896984073195527
4291,2128,6,292,166,2592,0.11265432098765432
4292,7318,1,164,362,7845,0.020905035054174632
4293,3376,16,268,162,3822,0.07012035583464155
4294,596,0,79,30,705,0.11205673758865248
4295,650,1,120,26,797,0.15056461731493098
4296,17264,7,207,469,17947,0.011533961107706023
4297,3107,4,55,269,3435,0.01601164483260553
4298,12451,14,1713,838,15016,0.11407831646244006
4299,5575,4,197,404,6180,0.031877022653721686
4300,3270,6,513,215,4004,0.1281218781218781
4301,4034,0,101,317,4452,0.022686433063791554
4302,1378,1,111,95,1585,0.07003154574132492
4303,2819,5,473,189,3486,0.13568559954102122
4304,3441,4,728,282,4455,0.16341189674523007
4305,17552,42,2211,1362,21167,0.10445504795200075
4306,2341,1,279,180,2801,0.09960728311317386
4307,1738,3,170,81,1992,0.0853413654618474
4308,7168,6,299,544,8017,0.03729574653860546
4309,2349,3,185,188,2725,0.06788990825688074
4310,30296,26,630,2536,33488,0.018812709030100336
4311,28501,61,1292,2175,32029,0.04033844328577227
4312,931,1,158,104,1194,0.1323283082077052
4313,1601,4,40,120,1765,0.0226628895184136
4314,1843,4,106,130,2083,0.050888142102736435
4315,2153,7,149,133,2442,0.061015561015561014
4316,3121,3,560,100,3784,0.14799154334038056
4317,9131,6,157,445,9739,0.016120751617209158
4318,5776,4,752,427,6959,0.10806150308952436
4319,2244,4,401,110,2759,0.14534251540413193
4320,4969,11,151,610,5741,0.026302037972478664
4321,43836,53,1532,3465,48886,0.03133821544000327
4322,15347,56,1700,858,17961,0.0946495184009799
4323,6647,8,1002,700,8357,0.11989948546128994
4324,16232,19,1858,793,18902,0.09829647656332663
4325,16711,47,2120,911,19789,0.10713022386174137
4326,726,2,123,54,905,0.13591160220994475
4327,1818,4,452,108,2382,0.1897565071368598
4328,417,0,30,30,477,0.06289308176100629
4329,3628,38,306,215,4187,0.07308335323620731
4330,2666,4,154,142,2966,0.051921780175320294
4331,8056,13,278,710,9057,0.030694490449376173
4332,1397,2,116,98,1613,0.07191568505889646
4333,8789,23,606,539,9957,0.06086170533293161
4334,1521,3,73,54,1651,0.044215626892792244
4335,15905,32,944,1244,18125,0.05208275862068965
4336,7798,40,718,305,8861,0.08102922920663581
4337,2084,2,300,110,2496,0.1201923076923077
4338,1639,4,122,126,1891,0.06451612903225806
4339,2895,11,210,148,3264,0.06433823529411764
4340,3192,6,195,152,3545,0.05500705218617771
4341,903,1,37,53,994,0.03722334004024145
4342,6593,14,347,507,7461,0.04650851092346871
4343,1413,1,191,99,1704,0.11208920187793427
4344,4469,4,127,242,4842,0.026228831061544815
4345,3258,7,60,194,3519,0.017050298380221655
4346,10142,37,703,637,11519,0.061029603264172234
4347,4330,7,87,280,4704,0.018494897959183673
4348,2267,3,68,164,2502,0.02717825739408473
4349,3371,4,538,124,4037,0.1332672776814466
4350,2601,2,262,106,2971,0.08818579602827331
4351,2452,4,276,170,2902,0.09510682288077188
4352,3357,17,122,311,3807,0.03204623062779091
4353,798,3,40,59,900,0.044444444444444446
4354,3861,10,231,272,4374,0.05281207133058985
4355,28668,33,4619,1472,34792,0.1327604046907335
4356,6094,16,963,196,7269,0.13248039620305407
4357,1479,1,291,101,1872,0.15544871794871795
4358,926,5,144,69,1144,0.1258741258741259
4359,3418,4,215,244,3881,0.055398093274929144
4360,4148,4,74,273,4499,0.01644809957768393
4361,5999,4,609,426,7038,0.08653026427962489
4362,1523,1,131,55,1710,0.07660818713450293
4363,3364,5,508,195,4072,0.12475442043222004
4364,2577,6,106,163,2852,0.03716690042075736
4365,4055,5,191,274,4525,0.04220994475138121
4366,2708,5,185,213,3111,0.05946640951462552
4367,2277,1,105,122,2505,0.041916167664670656
4368,14698,15,2048,732,17493,0.11707540158920711
4369,2777,5,277,167,3226,0.08586484810911345
4370,2551,5,246,147,2949,0.08341810783316378
4371,1855,2,427,60,2344,0.18216723549488054
4372,4756,9,189,341,5295,0.035694050991501414
4373,2408,2,299,344,3053,0.09793645594497216
4374,17407,16,617,746,18786,0.032843606941339296
4375,1136,1,174,50,1361,0.1278471711976488
4376,14881,15,1513,1213,17622,0.08585858585858586
4377,1343,6,163,71,1583,0.10296904611497157
4378,6675,8,278,290,7251,0.03833953937387947
4379,1201,1,190,60,1452,0.13085399449035812
4380,8331,12,515,307,9165,0.05619203491543917
4381,2960,5,85,269,3319,0.025610123531184092
4382,1088,0,94,83,1265,0.07430830039525692
4383,4561,9,291,324,5185,0.056123432979749276
4384,1074,2,44,64,1184,0.037162162162162164
4385,9215,39,726,434,10414,0.06971384674476666
4386,9670,20,1085,697,11472,0.09457810320781032
4387,7662,6,526,597,8791,0.05983392105562507
4388,11526,8,3495,690,15719,0.2223423881926331
4389,1335,0,205,65,1605,0.1277258566978193
4390,34007,33,1523,3156,38719,0.039334693561300656
4391,9556,17,635,805,11013,0.05765913011895033
4392,3694,6,336,164,4200,0.08
4393,1670,0,249,52,1971,0.1263318112633181
4394,37847,103,3271,2269,43490,0.0752126925730053
4395,9159,7,676,626,10468,0.06457776079480321
4396,1250,3,73,106,1432,0.05097765363128492
4397,1016,0,188,81,1285,0.1463035019455253
4398,3588,4,401,198,4191,0.09568122166547363
4399,933,6,184,87,1210,0.15206611570247933
4400,908,0,141,31,1080,0.13055555555555556
4401,1036,0,320,82,1438,0.22253129346314326
4402,3803,3,116,359,4281,0.027096472786732072
4403,2289,4,250,156,2699,0.09262689885142646
4404,88021,79,1850,7014,96964,0.01907924590569696
4405,2078,6,108,97,2289,0.047182175622542594
4406,1135,3,150,63,1351,0.11102886750555144
4407,3579,2,170,313,4064,0.041830708661417325
4408,8040,8,435,508,8991,0.048381715048381714
4409,1099,2,76,67,1244,0.06109324758842444
4410,25778,25,3491,1147,30441,0.1146808580532834
4411,2214,4,442,136,2796,0.15808297567954221
4412,795,3,132,43,973,0.13566289825282632
4413,5786,7,389,224,6406,0.06072432094911021
4414,2023,3,103,174,2303,0.04472427268779852
4415,547,1,54,32,634,0.08517350157728706
4416,7156,2,868,455,8481,0.10234642141256928
4417,4366,8,331,337,5042,0.06564855216184054
4418,976,1,48,82,1107,0.04336043360433604
4419,638,2,79,45,764,0.10340314136125654
4420,5567,9,549,434,6559,0.08370178380850739
4421,10357,13,491,449,11310,0.04341290893015031
4422,5911,16,148,415,6490,0.02280431432973806
4423,8952,21,1581,579,11133,0.14201023982753974
4424,6925,10,145,221,7301,0.019860293110532803
4425,6993,20,354,499,7866,0.04500381388253242
4426,10012,7,282,486,10787,0.026142579030314268
4427,35757,76,3669,2453,41955,0.08745084018591348
4428,1283,0,78,71,1432,0.05446927374301676
4429,1939,0,64,94,2097,0.030519790176442536
4430,1536,1,158,120,1815,0.08705234159779614
4431,4209,5,131,194,4539,0.028860982595285304
4432,13690,11,188,1299,15188,0.012378193310508295
4433,1717,8,453,64,2242,0.20205173951828725
4434,18578,29,675,1311,20593,0.03277812849026368
4435,1013,1,51,81,1146,0.04450261780104712
4436,3040,5,257,237,3539,0.07261938400678157
4437,6309,12,326,443,7090,0.045980253878702394
4438,12341,45,712,976,14074,0.05058973994599972
4439,1876,1,175,152,2204,0.0794010889292196
4440,10027,36,609,543,11215,0.05430227374052608
4441,1873,4,116,106,2099,0.055264411624583135
4442,2187,6,364,143,2700,0.1348148148148148
4443,2538,3,58,151,2750,0.02109090909090909
4444,21907,43,2350,604,24904,0.09436235142948923
4445,1776,3,157,83,2019,0.07776126795443289
4446,2972,5,342,250,3569,0.0958251611095545
4447,1326,0,144,120,1590,0.09056603773584905
4448,859,2,85,53,999,0.08508508508508508
4449,168,0,24,6,198,0.12121212121212122
4450,6888,15,548,448,7899,0.06937587036333713
4451,8091,15,637,373,9116,0.06987713909609478
4452,1144,2,66,312,1524,0.04330708661417323
4453,96,31,498,907,1532,0.32506527415143605
4454,3379,6,183,273,3841,0.04764384274928404
4455,6276,6,860,389,7531,0.11419466206347098
4456,4816,4,150,364,5334,0.0281214848143982
4457,436,0,67,41,544,0.12316176470588236
4458,4311,3,503,277,5094,0.09874361994503338
4459,7671,9,818,373,8871,0.09221057377973171
4460,3601,4,98,443,4146,0.02363724071394115
4461,3464,7,135,244,3850,0.03506493506493506
4462,912,1,147,78,1138,0.12917398945518455
4463,12706,21,389,341,13457,0.028906888608159324
4464,6143,10,143,462,6758,0.021160106540396566
4465,10117,11,1146,564,11838,0.0968068930562595
4466,3021,8,297,140,3466,0.08568955568378535
4467,56266,64,3379,3036,62745,0.053852896645151006
4468,2509,8,298,153,2968,0.10040431266846361
4469,4641,8,199,385,5233,0.03802789986623352
4470,2084,1,224,114,2423,0.09244737928188196
4471,4296,1,393,261,4951,0.07937790345384771
4472,5164,20,428,232,5844,0.0732375085557837
4473,1019,0,80,54,1153,0.06938421509106678
4474,2576,5,403,249,3233,0.12465202598206
4475,13725,21,788,1179,15713,0.05014955769108381
4476,10116,25,992,574,11707,0.08473562825659861
4477,1403,3,145,62,1613,0.08989460632362058
4478,2332,1,461,197,2991,0.15412905382815112
4479,3811,2,669,114,4596,0.14556135770234988
4480,23490,22,1187,877,25576,0.04641069752893338
4481,7410,15,224,269,7918,0.02828997221520586
4482,1071,0,173,36,1280,0.13515625
4483,5491,11,1235,311,7048,0.17522701475595914
4484,1267,2,86,74,1429,0.06018194541637509
4485,1929,7,145,103,2184,0.06639194139194139
4486,4008,5,530,153,4696,0.11286201022146508
4487,1219,0,292,46,1557,0.18754014129736674
4488,1737,1,99,102,1939,0.05105724600309438
4489,5137,4,284,479,5904,0.048102981029810296
4490,4007,6,406,244,4663,0.08706841089427407
4491,8462,14,1296,323,10095,0.12838038632986626
4492,10368,27,478,636,11509,0.04153271352854288
4493,4008,6,156,245,4415,0.03533408833522084
4494,2538,9,446,143,3136,0.14221938775510204
4495,1417,3,116,122,1658,0.06996381182147166
4496,2297,3,477,260,3037,0.15706289101086598
4497,2957,5,194,500,3656,0.05306345733041575
4498,3800,7,119,264,4190,0.028400954653937948
4499,9607,47,1237,839,11730,0.10545609548167093
4500,4398,9,1035,244,5686,0.18202602884277172
4501,6592,15,561,244,7412,0.07568807339449542
4502,5655,9,494,416,6574,0.07514450867052024
4503,2554,4,306,142,3006,0.10179640718562874
4504,27937,51,879,1256,30123,0.029180360521860373
4505,5127,14,334,447,5922,0.05639986491050321
4506,2300,11,337,124,2772,0.12157287157287157
4507,1478,4,117,136,1735,0.06743515850144093
4508,8568,15,2197,526,11306,0.19432159915089334
4509,81479,84,2214,4692,88469,0.02502571522228125
4510,1209,3,133,36,1381,0.09630702389572773
4511,2756,6,73,192,3027,0.02411628675256029
4512,5124,5,311,162,5602,0.05551588718314888
4513,1299,3,153,37,1492,0.10254691689008043
4514,8986,3,1505,795,11289,0.1333156169722739
4515,3474,10,239,295,4018,0.05948232951717272
4516,5852,6,233,418,6509,0.03579658933783991
4517,2157,5,97,139,2398,0.040450375312760634
4518,437,3,56,27,523,0.10707456978967496
4519,2920,6,126,96,3148,0.040025412960609914
4520,11414,21,341,1093,12869,0.026497785375709067
4521,4543,2,246,298,5089,0.0483395559048929
4522,15968,18,290,1485,17761,0.016327909464557176
4523,8326,16,1275,353,9970,0.12788365095285859
4524,3712,7,166,261,4146,0.04003859141341052
4525,20850,37,2135,698,23720,0.09000843170320405
4526,1422,1,280,57,1760,0.1590909090909091
4527,2480,10,169,170,2829,0.05973842347119123
4528,19968,38,472,1531,22009,0.021445772184106503
4529,4875,5,103,541,5524,0.018645908761766836
4530,2406,1,219,123,2749,0.07966533284830847
4531,1277,3,145,120,1545,0.09385113268608414
4532,7930,9,1431,540,9910,0.14439959636730576
4533,11770,13,824,691,13298,0.06196420514363062
4534,14222,29,3113,532,17896,0.17394948591864104
4535,2159,2,130,108,2399,0.054189245518966235
4536,17455,33,2712,1257,21457,0.12639231952276647
4537,1796,1,168,104,2069,0.08119864668922185
4538,71102,124,8838,4482,84546,0.10453480945284224
4539,1549,7,253,165,1974,0.1281661600810537
4540,9940,6,1929,626,12501,0.154307655387569
4541,1144,5,65,76,1290,0.050387596899224806
4542,11638,24,661,1040,13363,0.0494649405073711
4543,24864,39,538,2004,27445,0.019602842047731828
4544,3126,6,57,247,3436,0.01658905704307334
4545,13679,21,511,872,15083,0.033879201750314926
4546,32776,54,1129,1027,34986,0.03227005087749386
4547,6012,23,413,320,6768,0.061022458628841605
4548,5219,15,254,248,5736,0.04428172942817294
4549,3699,3,576,221,4499,0.12802845076683708
4550,6111,4,185,549,6849,0.027011242517155788
4551,3724,8,481,204,4417,0.10889744170251302
4552,6714,8,893,724,8339,0.10708718071711236
4553,1604,4,145,98,1851,0.07833603457590492
4554,11392,30,479,363,12264,0.03905740378343118
4555,7677,14,593,511,8795,0.06742467310972143
4556,1902,2,137,189,2230,0.06143497757847534
4557,7341,18,415,983,8757,0.04739065890145027
4558,8763,20,2163,398,11344,0.1906734837799718
4559,2200,6,173,117,2496,0.06931089743589744
4560,3213,2,297,275,3787,0.07842619487721152
4561,2920,3,168,268,3359,0.05001488538255433
4562,7532,11,1480,403,9426,0.15701251856566942
4563,1140,4,63,53,1260,0.05
4564,4534,10,335,322,5201,0.06441069025187464
4565,2627,9,203,190,3029,0.06701881809177947
4566,47469,82,1316,3099,51966,0.02532425047146211
4567,27199,85,1163,2437,30884,0.03765703924362129
4568,9744,18,628,578,10968,0.05725747629467542
4569,2477,3,418,96,2994,0.1396125584502338
4570,9671,6,146,392,10215,0.01429270680372002
4571,4676,13,338,173,5200,0.065
4572,3258,3,160,131,3552,0.04504504504504504
4573,4038,9,738,201,4986,0.148014440433213
4574,895,0,40,56,991,0.04036326942482341
4575,1199,4,105,67,1375,0.07636363636363637
4576,2907,4,52,172,3135,0.016586921850079744
4577,3110,4,761,159,4034,0.1886465047099653
4578,4531,11,231,364,5137,0.044967880085653104
4579,444,3,55,13,515,0.10679611650485436
4580,4093,8,436,246,4783,0.0911561781308802
4581,1476,3,104,149,1732,0.06004618937644342
4582,5847,19,566,405,6837,0.08278484715518503
4583,4072,18,396,221,4707,0.0841300191204589
4584,4732,12,480,364,5588,0.08589835361488905
4585,20377,44,2384,920,23725,0.10048472075869336
4586,737,0,97,41,875,0.11085714285714286
4587,1475,5,118,82,1680,0.07023809523809524
4588,1382,3,240,56,1681,0.14277215942891136
4589,6149,14,1200,393,7756,0.15471892728210418
4590,2934,3,159,184,3280,0.04847560975609756
4591,1234,2,181,76,1493,0.12123241795043536
4592,1813,2,199,44,2058,0.0966958211856171
4593,4674,10,309,350,5343,0.05783267827063447
4594,10361,26,1357,659,12403,0.10940901394823833
4595,686,1,111,22,820,0.1353658536585366
4596,1113,8,175,32,1328,0.13177710843373494
4597,10071,12,498,930,11511,0.04326296585874381
4598,2830,6,424,413,3673,0.11543697250204192
4599,11658,7,1721,643,14029,0.12267446004704541
4600,9076,15,1530,307,10928,0.1400073206442167
4601,1092,2,205,74,1373,0.14930808448652585
4602,6599,9,155,355,7118,0.02177577971340264
4603,1040,4,58,48,1150,0.050434782608695654
4604,697,0,76,15,788,0.09644670050761421
4605,46546,62,6896,3439,56943,0.12110355970005093
4606,5832,4,299,443,6578,0.045454545454545456
4607,15386,36,1032,828,17282,0.059715310727925006
4608,2495,8,82,108,2693,0.030449313033791312
4609,2087,2,137,321,2547,0.053788771103258734
4610,626,2,64,44,736,0.08695652173913043
4611,2053,3,261,166,2483,0.10511478050745067
4612,936,2,86,33,1057,0.08136234626300852
4613,2654,10,78,260,3002,0.02598267821452365
4614,2589,3,575,231,3398,0.16921718658034138
4615,20035,45,1912,1201,23193,0.0824386668391325
4616,7952,8,734,597,9291,0.07900118394144871
4617,1617,1,142,155,1915,0.07415143603133159
4618,4319,18,286,725,5348,0.053477935676888556
4619,2057,2,302,190,2551,0.11838494707957664
4620,1450,3,84,127,1664,0.05048076923076923
4621,456,0,52,13,521,0.09980806142034548
4622,18746,26,1807,984,21563,0.08380095534016603
4623,1406,3,95,109,1613,0.05889646621202728
4624,992,1,53,71,1117,0.047448522829006266
4625,2294,8,391,180,2873,0.13609467455621302
4626,1436,2,240,56,1734,0.1384083044982699
4627,989,2,57,57,1105,0.051583710407239816
4628,3265,3,564,175,4007,0.14075368105814823
4629,6151,7,824,509,7491,0.10999866506474436
4630,5977,7,1010,165,7159,0.1410811565861154
4631,5806,9,236,399,6450,0.03658914728682171
4632,4560,13,270,325,5168,0.05224458204334365
4633,4917,4,913,162,5996,0.15226817878585724
4634,965,2,134,40,1141,0.11744084136722173
4635,3909,7,178,250,4344,0.040976058931860036
4636,2279,7,135,130,2551,0.052920423363386905
4637,1370,3,61,103,1537,0.039687703318152245
4638,1666,9,454,71,2200,0.20636363636363636
4639,682,2,65,25,774,0.08397932816537468
4640,14847,22,948,928,16745,0.05661391460137354
4641,1363,2,248,180,1793,0.13831567205800335
4642,6472,2,1624,317,8415,0.19298871063576947
4643,4067,9,1055,326,5457,0.1933296683159245
4644,64318,164,10760,2415,77657,0.13855801795073205
4645,5933,17,466,316,6732,0.06922162804515745
4646,3737,5,273,271,4286,0.06369575361642557
4647,4210,2,444,346,5002,0.08876449420231908
4648,10823,24,2364,593,13804,0.17125470878006374
4649,3129,10,490,183,3812,0.1285414480587618
4650,6767,14,1607,579,8967,0.179212668674027
4651,8553,22,714,506,9795,0.07289433384379786
4652,1371,1,151,96,1619,0.0932674490426189
4653,1510,7,209,112,1838,0.11371055495103373
4654,1483,5,208,79,1775,0.1171830985915493
4655,11171,11,353,792,12327,0.028636326762391497
4656,2037,6,179,145,2367,0.07562315166877905
4657,7633,13,579,418,8643,0.06699062825407845
4658,11514,29,1350,748,13641,0.09896635144051022
4659,29173,55,4369,2705,36302,0.12035149578535619
4660,5287,3,182,407,5879,0.03095764585813914
4661,3699,6,274,168,4147,0.06607185917530745
4662,3589,6,357,169,4121,0.0866294588692065
4663,4734,4,499,380,5617,0.08883745771764287
4664,815,3,54,29,901,0.05993340732519423
4665,1954,5,99,128,2186,0.04528819762122598
4666,7937,15,647,493,9092,0.07116146062472503
4667,13251,13,726,1451,15441,0.04701768020205945
4668,4819,9,192,500,5520,0.034782608695652174
4669,4194,16,147,218,4575,0.032131147540983604
4670,3620,1,256,179,4056,0.0631163708086785
4671,830,1,76,35,942,0.08067940552016985
4672,5362,2,138,542,6044,0.022832561217736597
4673,3836,4,582,138,4560,0.12763157894736843
4674,3871,8,45,154,4078,0.011034820990681708
4675,4070,15,199,184,4468,0.04453894359892569
4676,1175,6,37,75,1293,0.028615622583139984
4677,4194,4,615,164,4977,0.12356841470765521
4678,3555,1,551,230,4337,0.1270463454000461
4679,911,0,145,47,1103,0.1314596554850408
4680,14736,28,1273,686,16723,0.07612270525623394
4681,3504,6,68,238,3816,0.01781970649895178
4682,2379,6,199,181,2765,0.07197106690777577
4683,10451,10,244,791,11496,0.021224773834377174
4684,5896,10,479,365,6750,0.07096296296296296
4685,17488,20,1931,830,20269,0.09526863683457497
4686,17065,109,890,1041,19105,0.046584663700601936
4687,11849,25,1811,624,14309,0.12656370116709764
4688,72122,88,2912,4361,79483,0.03663676509442271
4689,1847,3,103,151,2104,0.04895437262357415
4690,1284,3,153,50,1490,0.10268456375838926
4691,793,2,70,60,925,0.07567567567567568
4692,938,3,44,96,1081,0.04070305272895467
4693,19774,5,544,1025,21348,0.025482480794453814
4694,3036,6,427,274,3743,0.11407961528185948
4695,15273,28,1157,826,17284,0.06694052302707706
4696,4792,14,568,246,5620,0.10106761565836299
4697,1934,4,284,123,2345,0.12110874200426439
4698,1946,7,292,131,2376,0.12289562289562289
4699,1960,5,214,75,2254,0.09494232475598935
4700,20066,22,1869,2110,24067,0.07765820417999751
4701,2126,3,96,194,2419,0.03968582058701943
4702,3915,8,266,270,4459,0.059654631083202514
4703,19975,28,833,1554,22390,0.03720410897722198
4704,2666,1,359,394,3420,0.10497076023391813
4705,11468,38,2614,887,15007,0.17418538015592724
4706,1260,3,74,98,1435,0.05156794425087108
4707,8006,7,1083,533,9629,0.11247273860213937
4708,19831,38,2735,1580,24184,0.11309130003307973
4709,6619,19,2161,202,9001,0.2400844350627708
4710,6828,13,680,430,7951,0.0855238334800654
4711,654,5,44,48,751,0.05858854860186418
4712,4970,3,309,245,5527,0.055907363850189976
4713,2600,9,402,99,3110,0.1292604501607717
4714,1925,1,446,82,2454,0.1817440912795436
4715,1321,2,255,66,1644,0.1551094890510949
4716,1849,1,66,67,1983,0.03328290468986384
4717,2101,0,97,143,2341,0.04143528406663819
4718,8601,21,769,357,9748,0.07888797702092737
4719,2533,1,196,164,2894,0.06772633033863165
4720,10882,4,1704,374,12964,0.13144091329836471
4721,1537,2,97,134,1770,0.05480225988700565
4722,1704,1,98,118,1921,0.05101509630400833
4723,1468,8,33,112,1621,0.020357803824799507
4724,7872,9,899,464,9244,0.09725227174383384
4725,3779,11,445,400,4635,0.09600862998921252
4726,3583,14,385,126,4108,0.09371957156767283
4727,4213,14,435,224,4886,0.08902988129349161
4728,5476,15,250,267,6008,0.04161118508655127
4729,10283,16,280,496,11075,0.02528216704288939
4730,1277,3,163,89,1532,0.10639686684073107
4731,22679,49,1740,1330,25798,0.06744708892162184
4732,2474,2,146,81,2703,0.05401405845357011
4733,2196,4,270,111,2581,0.10461061604029447
4734,1397,1,116,79,1593,0.07281858129315756
4735,7097,5,241,213,7556,0.03189518263631551
4736,1507,2,104,78,1691,0.06150206978119456
4737,4638,3,412,293,5346,0.07706696595585484
4738,4021,2,215,185,4423,0.04860954103549627
4739,5072,11,224,370,5677,0.03945745992601726
4740,9212,14,646,606,10478,0.061652987211299866
4741,9271,8,769,393,10441,0.07365194904702614
4742,1367,4,71,100,1542,0.046044098573281456
4743,1773,8,137,107,2025,0.06765432098765432
4744,10143,18,1248,521,11930,0.10461022632020117
4745,4413,10,516,163,5102,0.10113680909447276
4746,1347,2,235,167,1751,0.1342090234151913
4747,5050,6,859,254,6169,0.13924461014751174
4748,779,1,45,33,858,0.05244755244755245
4749,1251,2,131,83,1467,0.08929788684389911
4750,4678,4,178,286,5146,0.03458997279440342
4751,25750,40,1583,1930,29303,0.05402177251475958
4752,213021,241,3669,14346,231277,0.01586409370581597
4753,2962,3,79,150,3194,0.024733876017532873
4754,2317,0,189,69,2575,0.07339805825242718
4755,2469,3,231,141,2844,0.08122362869198312
4756,10019,18,1258,471,11766,0.1069182389937107
4757,3867,2,943,153,4965,0.18992950654582075
4758,3767,12,264,301,4344,0.06077348066298342
4759,2852,6,163,158,3179,0.051273985530040894
4760,85706,249,7591,4887,98433,0.0771184460495972
4761,2602,1,228,115,2946,0.07739307535641547
4762,1092,4,123,42,1261,0.09754163362410785
4763,1585,9,84,117,1795,0.0467966573816156
4764,3102,3,287,167,3559,0.08064062939027816
4765,11596,26,1250,626,13498,0.09260631204622907
4766,63962,170,7554,3128,74814,0.10097040660838881
4767,1143,1,118,53,1315,0.08973384030418251
4768,14892,18,627,1208,16745,0.03744401313825022
4769,3006,10,467,164,3647,0.12805045242665206
4770,2880,3,779,160,3822,0.20381998953427524
4771,5789,10,1066,333,7198,0.14809669352597943
4772,1371,1,128,66,1566,0.08173690932311622
4773,9737,20,462,1714,11933,0.038716165256012736
4774,896,0,137,45,1078,0.12708719851576994
4775,32714,46,912,2276,35948,0.02536997885835095
4776,13933,34,861,751,15579,0.055266705180050064
4777,761,1,79,57,898,0.08797327394209355
4778,3355,6,243,293,3897,0.06235565819861432
4779,3961,2,117,239,4319,0.027089604075017364
4780,1989,4,256,89,2338,0.10949529512403763
4781,13830,31,926,1150,15937,0.05810378364811445
4782,2280,4,47,163,2494,0.01884522854851644
4783,13241,33,1898,660,15832,0.11988377968671046
4784,2666,9,78,207,2960,0.026351351351351353
4785,19404,15,2163,1081,22663,0.09544190972069011
4786,4848,5,164,423,5440,0.030147058823529412
4787,8402,17,645,467,9531,0.06767390620081838
4788,1330,0,94,244,1668,0.05635491606714628
4789,5787,9,631,274,6701,0.09416504999253843
4790,5836,6,115,329,6286,0.018294622971683105
4791,3278,9,299,366,3952,0.0756578947368421
4792,36408,45,4854,2351,43658,0.11118237207384672
4793,3265,18,755,95,4133,0.18267602225985966
4794,4112,10,377,181,4680,0.08055555555555556
4795,2290,5,192,150,2637,0.07281001137656427
4796,4690,8,788,242,5728,0.13756983240223464
4797,1341,0,319,25,1685,0.18931750741839762
4798,121698,202,4392,5966,132258,0.03320782107698589
4799,1391,1,200,55,1647,0.12143290831815422
4800,1122,3,184,97,1406,0.13086770981507823
4801,1737,2,36,80,1855,0.01940700808625337
4802,2739,1,175,143,3058,0.05722694571615435
4803,19574,85,633,3778,24070,0.026298296634815123
4804,1970,1,439,135,2545,0.1724950884086444
4805,3484,7,277,275,4043,0.06851348008904279
4806,978,3,140,59,1180,0.11864406779661017
4807,781,2,238,12,1033,0.23039690222652467
4808,2777,13,247,120,3157,0.07823883433639531
4809,4575,8,215,386,5184,0.04147376543209876
4810,5290,7,401,210,5908,0.06787406905890318
4811,3628,6,364,136,4134,0.0880503144654088
4812,1624,8,138,129,1899,0.07266982622432859
4813,2654,7,167,191,3019,0.05531632991056641
4814,3653,7,442,198,4300,0.1027906976744186
4815,2082,7,143,148,2380,0.06008403361344538
4816,5211,8,193,548,5960,0.03238255033557047
4817,3238,8,394,117,3757,0.10487090763907372
4818,43268,129,2733,1959,48089,0.05683212377050885
4819,3546,4,136,352,4038,0.033680039623576026
4820,6291,16,248,439,6994,0.035458964826994566
4821,2184,4,313,123,2624,0.11928353658536585
4822,4935,0,74,215,5224,0.014165390505359877
4823,3196,10,71,199,3476,0.020425776754890677
4824,2280,7,264,113,2664,0.0990990990990991
4825,5844,8,836,274,6962,0.1200804366561333
4826,3629,8,554,144,4335,0.12779700115340253
4827,3477,10,396,149,4032,0.09821428571428571
4828,14329,54,2373,892,17648,0.13446282864913872
4829,10602,31,549,870,12052,0.045552605376700965
4830,2027,0,189,162,2378,0.07947855340622371
4831,982,0,219,51,1252,0.17492012779552715
4832,7023,13,824,825,8685,0.0948762233736327
4833,6461,14,177,170,6822,0.025945470536499562
4834,4157,1,191,194,4543,0.042042703059652214
4835,1618,6,171,67,1862,0.09183673469387756
4836,7314,3,304,519,8140,0.03734643734643735
4837,1477,2,142,86,1707,0.08318687756297598
4838,3229,7,195,207,3638,0.05360087960417812
4839,3220,6,380,187,3793,0.10018455048774058
4840,4599,11,243,361,5214,0.04660529344073648
4841,2926,6,316,117,3365,0.09390787518573551
4842,1354,1,140,142,1637,0.0855222968845449
4843,8259,17,133,472,8881,0.014975791014525392
4844,4385,2,279,271,4937,0.05651205185335224
4845,129496,97,3978,6492,140063,0.028401505037019055
4846,5244,5,517,326,6092,0.08486539724228497
4847,104268,107,2730,6666,113771,0.02399557004860641
4848,7241,20,507,277,8045,0.06302050963331261
4849,4278,12,183,359,4832,0.03787251655629139
4850,45394,69,2851,2145,50459,0.05650131790166273
4851,2729,8,190,119,3046,0.0623768877216021
4852,11005,4,240,887,12136,0.01977587343441002
4853,2107,0,238,150,2495,0.09539078156312625
4854,1071,7,184,123,1385,0.1328519855595668
4855,1700,3,121,90,1914,0.06321839080459771
4856,3676,2,166,372,4216,0.03937381404174573
4857,10723,13,930,627,12293,0.07565281054258521
4858,7012,21,534,380,7947,0.06719516798791997
4859,4192,14,414,408,5028,0.08233890214797136
4860,4964,9,794,256,6023,0.13182799269467044
4861,1160,1,219,56,1436,0.15250696378830084
4862,1428,8,98,92,1626,0.06027060270602706
4863,1307,4,112,77,1500,0.07466666666666667
4864,25016,79,2477,891,28463,0.0870252608649826
4865,24593,60,2349,1297,28299,0.08300646665959928
4866,2594,5,68,154,2821,0.024104927330733782
4867,3557,4,301,408,4270,0.07049180327868852
4868,3523,8,888,254,4673,0.19002781938797347
4869,42830,74,1661,2799,47364,0.035068828646229205
4870,2185,4,359,81,2629,0.13655382274629135
4871,13959,23,3918,551,18451,0.21234621429732806
4872,2036,2,139,210,2387,0.05823209049015501
4873,2065,4,287,123,2479,0.11577248890681727
4874,4264,6,315,173,4758,0.06620428751576292
4875,1284,5,136,107,1532,0.08877284595300261
4876,5642,14,523,446,6625,0.0789433962264151
4877,2762,3,176,137,3078,0.057179987004548405
4878,510,1,20,12,543,0.03683241252302026
4879,12058,21,379,971,13429,0.028222503537121156
4880,1276,6,228,111,1621,0.1406539173349784
4881,20344,27,1618,1457,23446,0.0690096391708607
4882,9747,14,1828,383,11972,0.1526896090878717
4883,8046,14,1091,431,9582,0.11385931955750365
4884,2171,4,245,157,2577,0.09507178890182383
4885,1886,2,206,109,2203,0.0935088515660463
4886,3417,1,530,151,4099,0.12929982922664066
4887,918,0,185,40,1143,0.16185476815398075
4888,9643,24,1076,590,11333,0.09494396894026295
4889,1364,2,255,117,1738,0.14672036823935558
4890,2407,3,223,144,2777,0.0803024846957148
4891,3312,11,317,175,3815,0.08309305373525556
4892,1564,8,86,149,1807,0.047592695074709465
4893,3053,7,363,151,3574,0.10156687185226637
4894,2563,17,267,132,2979,0.08962739174219536
4895,4766,14,423,505,5708,0.07410651716888578
4896,4627,8,295,296,5226,0.05644852659778033
4897,1583,4,200,118,1905,0.10498687664041995
4898,9846,14,633,626,11119,0.05692957999820128
4899,4421,6,349,270,5046,0.06916369401506144
4900,7000,24,671,334,8029,0.0835720513139868
4901,1861,5,247,130,2243,0.11012037449843959
4902,575,1,60,35,671,0.08941877794336811
4903,2702,4,857,132,3695,0.23193504736129905
4904,1169,3,104,87,1363,0.07630227439471754
4905,1799,3,317,50,2169,0.14615029967727064
4906,1665,1,121,115,1902,0.06361724500525763
4907,2004,3,140,115,2262,0.0618921308576481
4908,5439,10,638,405,6492,0.09827479975354282
4909,6284,4,576,363,7227,0.07970112079701121
4910,10644,16,219,842,11721,0.018684412592782185
4911,18026,25,1074,1867,20992,0.05116234756097561
4912,823,0,131,46,1000,0.131
4913,1871,1,125,175,2172,0.05755064456721915
4914,5032,16,134,491,5673,0.02362065926317645
4915,3715,5,67,212,3999,0.016754188547136784
4916,3036,2,186,242,3466,0.05366416618580496
4917,3506,6,176,212,3900,0.04512820512820513
4918,119655,173,7880,7176,134884,0.0584205687850301
4919,14221,71,1558,1021,16871,0.09234781577855491
4920,9724,10,343,442,10519,0.032607662325316096
4921,4470,5,133,297,4905,0.02711518858307849
4922,5005,2,670,345,6022,0.11125871803387578
4923,13892,17,1797,670,16376,0.10973375671714704
4924,116973,159,2453,7179,126764,0.019350919819507116
4925,7066,8,202,781,8057,0.025071366513590668
4926,15449,23,963,898,17333,0.05555876074539895
4927,5133,19,86,134,5372,0.01600893521965748
4928,1162,2,93,49,1306,0.07120980091883614
4929,1947,5,88,84,2124,0.04143126177024482
4930,3922,3,262,320,4507,0.05813179498557799
4931,968,2,29,28,1027,0.028237585199610515
4932,3531,1,299,227,4058,0.07368161655988172
4933,7814,22,781,579,9196,0.08492822966507177
4934,1654,3,70,126,1853,0.037776578521316787
4935,1210,0,127,96,1433,0.08862526168876483
4936,13432,16,937,880,15265,0.061382246970193254
4937,2167,3,171,164,2505,0.06826347305389222
4938,3908,9,422,385,4724,0.08933107535986452
4939,13404,39,1837,899,16179,0.11354224612151555
4940,9114,3,184,450,9751,0.01886985950158958
4941,2607,8,115,269,2999,0.0383461153717906
4942,5478,18,797,371,6664,0.11959783913565426
4943,2878,3,297,144,3322,0.08940397350993377
4944,1317,5,291,68,1681,0.17311124330755503
4945,114456,153,6516,15455,136580,0.04770830282618246
4946,4214,3,223,193,4633,0.04813295920569825
4947,4011,12,205,239,4467,0.045892097604656366
4948,2878,5,187,227,3297,0.056718228692750984
4949,47793,27,955,2037,50812,0.018794772888294103
4950,36251,62,5563,2257,44133,0.12605080098792287
4951,31335,53,1725,1469,34582,0.04988144121219131
4952,916,3,59,34,1012,0.058300395256917
4953,5499,11,325,319,6154,0.05281117972050699
4954,3674,7,163,321,4165,0.039135654261704685
4955,5807,36,1247,297,7387,0.16881007174766482
4956,1750,2,255,54,2061,0.12372634643377002
4957,2382,3,156,98,2639,0.059113300492610835
4958,1344,2,275,69,1690,0.16272189349112426
4959,13090,31,449,928,14498,0.03096978893640502
4960,4733,4,574,257,5568,0.10308908045977011
4961,7768,18,551,634,8971,0.06142013153494594
4962,3764,2,189,259,4214,0.044850498338870434
4963,17308,22,2510,1589,21429,0.11713099071351907
4964,7629,10,298,345,8282,0.03598164694518232
4965,4533,10,109,429,5081,0.021452469986223185
4966,30528,71,5435,2194,38228,0.1421732761326776
4967,1515,0,81,120,1716,0.0472027972027972
4968,2071,2,243,134,2450,0.09918367346938775
4969,1812,1,126,84,2023,0.06228373702422145
4970,289,1,47,22,359,0.1309192200557103
4971,3410,6,277,138,3831,0.0723048812320543
4972,4732,5,126,347,5210,0.02418426103646833
4973,1228,1,126,45,1400,0.09
4974,4385,9,301,372,5067,0.05940398657983027
4975,1206,1,138,51,1396,0.0988538681948424
4976,225709,424,8587,16380,251100,0.03419753086419753
4977,1609,3,113,142,1867,0.06052490626673808
4978,2816,8,161,152,3137,0.051322919987248965
4979,3664,5,264,258,4191,0.06299212598425197
4980,2674,2,103,173,2952,0.03489159891598916
4981,4894,17,440,219,5570,0.07899461400359066
4982,6624,13,572,464,7673,0.07454711325426822
4983,11469,25,566,719,12779,0.04429141560372486
4984,2260,1,110,182,2553,0.04308656482569526
4985,8215,13,765,364,9357,0.0817569733889067
4986,2677,2,105,211,2995,0.035058430717863104
4987,2465,4,356,144,2969,0.11990569215223981
4988,2925,0,119,148,3192,0.03728070175438596
4989,2224,2,192,125,2543,0.07550137632717263
4990,11831,12,1204,519,13566,0.08875128998968008
4991,556,2,80,28,666,0.12012012012012012
4992,11380,20,1971,505,13876,0.14204381666186222
4993,12324,18,769,1156,14267,0.05390060979883648
4994,5756,13,164,226,6159,0.026627699301834715
4995,6134,16,911,447,7508,0.12133724027703782
